block_number,block_timestamp,my_timestamp,timestamp_delta,tx_count,avg_gas_price,median_gas_price,q5_gas_price,q95_gas_price
5472074,1524196132,1524196148,16,203,15.443980983242996,7.0,4.0,50.0
5472075,1524196139,1524196153,14,212,6.200375092581884,4.0,2.0,7.792191499999998
5472076,1524196149,1524196165,16,182,7.871575143393505,3.29,0.9057447944660325,41.0
5472077,1524196162,1524196175,13,133,7.914749618166061,4.0,1.0,41.0
5472078,1524196172,1524196187,15,171,11.299771839456028,4.0,1.0,50.0
5472079,1524196188,1524196981,793,194,12.22646195428044,4.0,1.0,53.79760086294416
5472080,1524196193,1524196982,789,94,4.7935289565671555,1.5277218280216478,1.0,20.969941815565583
5472083,1524196232,1524197011,779,102,10.776742624202226,4.0,1.2,41.0
5472087,1524196278,1524197012,734,170,13.782055082965,5.0,1.0,52.91944515008854
5472091,1524196331,1524197013,682,209,4.08111174008844,2.0,1.0,12.435797220009738
5472093,1524196376,1524197015,639,138,11.970919686358156,4.0,0.7799167469852831,48.001979777904836
5472096,1524196406,1524197016,610,210,10.049623899666816,4.324866343949045,1.0,24.0
5472099,1524196422,1524197017,595,144,13.56405940942806,4.0,2.2,50.0
5472101,1524196427,1524197019,592,119,2.083274522319899,1.5844133333333335,1.0,5.589971667374854
5472104,1524196464,1524197020,556,88,4.935623043763029,4.0,1.0,17.386261684579928
5472106,1524196500,1524197021,521,121,7.350330804261284,1.5,1.0,42.16605995685476
5472109,1524196536,1524197022,486,83,3.892045545391756,1.5,0.6,21.180447058823518
5472111,1524196587,1524197024,437,198,15.74904835807459,5.0,1.2,53.124381460921505
5472114,1524196636,1524197025,389,94,6.368825463904214,1.5278703509852216,1.0,30.618489999999884
5472117,1524196673,1524197026,353,41,26.772939535285627,20.0,0.0,55.0
5472120,1524196710,1524197027,317,107,6.560768698384677,2.160469105691058,1.0,26.681828703703626
5472122,1524196784,1524197028,244,100,8.783228181389614,8.0,8.0,10.0
5472125,1524196805,1524197030,225,105,4.925666381076242,1.5,1.0,9.912206700127236
5472129,1524196872,1524197031,159,207,10.035459820405432,5.0,5.0,30.0
5472131,1524196883,1524197032,149,87,9.407911886586477,8.0,7.950749836065574,12.39162347260468
5472132,1524196916,1524197033,117,175,10.15861555427499,5.0,4.0,40.0
5472133,1524196924,1524197035,111,92,21.33409227641408,8.0,8.0,81.84030061291843
5472134,1524196929,1524197036,107,94,4.000485727991741,4.0,2.0,6.635553142857141
5472136,1524196953,1524197037,84,76,5.121722095086256,3.122485798816568,0.51,20.90382575051277
5472138,1524196980,1524197038,58,131,11.89640392598883,4.0,4.0,50.0
5472142,1524197028,1524197040,12,15,48.49636104250897,40.0,20.6960921875,104.34149586998166
5472143,1524197032,1524197047,15,209,6.006603832601672,5.0,4.0,10.0
5472144,1524197045,1524197067,22,204,12.560641701594758,5.0,4.0,40.679949549549534
5472145,1524197063,1524197085,22,229,22.755255130879807,5.0,4.0,49.56439047018216
5472146,1524197071,1524197107,36,124,27.993720364714466,5.0,4.0,88.0
5472147,1524197087,1524197124,37,215,10.147503109063726,4.0,4.0,50.0
5472148,1524197123,1524197131,8,121,60.86557775929897,40.0,0.0,259.86444043126676
5472149,1524197128,1524197182,54,200,8.200501937098915,4.077449224133417,4.0,36.274329411764654
5472150,1524197178,1524197196,18,87,27.207471339281426,22.144910900254573,4.0,54.013561648232425
5472151,1524197182,1524197214,32,182,13.306361057902885,5.0,4.0,40.0
5472152,1524197213,1524197224,11,203,19.225660289916554,6.0,4.0,55.0
5472153,1524197223,1524197232,9,186,7.1260237475553305,5.0,4.0,19.514187321295957
5472154,1524197227,1524197241,14,249,6.148681985698823,4.0,1.0,29.088892941176294
5472155,1524197232,1524197249,17,221,6.591938447640459,4.0,4.0,21.0
5472156,1524197248,1524197261,13,229,9.849454207131604,4.0,4.0,50.0
5472157,1524197259,1524197280,21,231,13.519503510558565,4.0,4.0,55.0
5472158,1524197277,1524197287,10,245,21.32121924867554,4.0,1.0,55.81106355078097
5472159,1524197282,1524197300,18,196,10.895934019988088,4.0,4.0,53.67011314865388
5472160,1524197296,1524197331,35,206,6.373837071638982,4.0,4.0,17.0
5472161,1524197332,1524197348,16,208,17.134001437831937,8.0,4.0,53.979760860882756
5472162,1524197348,1524197377,29,208,15.434652030657983,8.0,4.0,38.72489941293827
5472163,1524197377,1524197389,12,196,10.249753312675463,5.0,4.0,49.56154016419258
5472164,1524197388,1524197396,8,221,11.583480386669903,4.0,4.0,50.0
5472165,1524197393,1524197415,22,105,47.74793914160581,50.0,17.399725161290323,80.08042162162158
5472166,1524197415,1524197447,32,201,6.862239286560828,5.0,4.0,24.0
5472167,1524197446,1524197463,17,199,15.00583127490519,5.0,4.0,59.422577995724275
5472168,1524197462,1524197472,10,211,10.16197107627178,4.088112068965515,4.0,41.86895457563461
5472169,1524197469,1524197488,19,225,10.101206518696026,4.0,4.0,22.93622314279102
5472170,1524197484,1524197496,12,218,12.608651230823423,4.0,4.0,51.765459818334364
5472171,1524197493,1524197513,20,176,13.947165859960444,5.0,4.0,55.0
5472172,1524197511,1524197525,14,200,28.33501681489379,10.0,4.0,88.70647803545435
5472173,1524197524,1524197529,5,221,7.2767032113968355,4.0,4.0,29.78309848484824
5472174,1524197530,1524197537,7,219,6.409988148919678,4.0,4.0,10.926267349873804
5472175,1524197536,1524197547,11,226,5.290994997519039,4.0,4.0,18.713527519312386
5472176,1524197547,1524197554,7,247,5.951252100325704,4.0,1.0,30.0
5472177,1524197553,1524197569,16,223,8.198330905905086,4.0,4.0,35.90093379310342
5472178,1524197570,1524197633,63,225,7.255577382701724,4.0,1.0,24.674792611150966
5472179,1524197633,1524197648,15,127,21.27892240679189,20.0,5.0,55.0
5472180,1524197647,1524197660,13,121,24.811885252034656,8.0,8.0,55.0
5472181,1524197660,1524197667,7,223,8.234090173050479,4.0,4.0,24.021592237827733
5472182,1524197669,1524197681,12,219,7.277084399765265,4.0,4.0,33.851723079103316
5472183,1524197682,1524197691,9,219,11.012486090396937,4.0,4.0,52.38752714932124
5472184,1524197689,1524197699,10,104,15.498565316263102,8.0,8.0,55.0
5472185,1524197690,1524197722,32,168,11.957458270650958,8.0,4.0,34.96043839467887
5472186,1524197720,1524197728,8,138,17.802615875336176,9.370867673055622,4.0,60.0
5472187,1524197728,1524197736,8,9,6.4232645975352325,0.0001954590456,0.0,52.95950652187881
5472188,1524197733,1524197743,10,233,11.693190407727265,4.0,1.0,55.0
5472189,1524197741,1524197755,14,226,6.218996165419948,4.0,4.0,10.392700376615029
5472192,1524197761,1524197767,6,216,4.0,4.0,4.0,4.0
5472193,1524197763,1524197786,23,216,8.063154046707712,4.0,4.0,24.0
5472194,1524197783,1524197796,13,215,16.28819038154317,9.48165806394409,4.0,46.806274866071426
5472195,1524197794,1524197815,21,215,11.918738964413524,5.097654330708662,4.0,42.99502499999996
5472196,1524197800,1524197816,16,178,6.973362027665088,4.0,4.0,18.005951847327474
5472197,1524197811,1524197826,15,233,8.885604203901472,4.0,4.0,23.14040842397593
5472198,1524197825,1524197833,8,222,39.207445898532086,39.0,4.0,91.0
5472199,1524197832,1524197839,7,203,8.325786494935556,4.0,4.0,50.0
5472200,1524197838,1524197851,13,214,7.800594326515371,4.0,4.0,41.0
5472201,1524197850,1524197861,11,11,61.43984291126856,50.39142714285714,47.19006842105263,109.06320382872224
5472202,1524197858,1524197873,15,197,10.459945976382617,5.0,4.0,23.778571778290992
5472203,1524197871,1524197878,7,224,8.532286056570921,4.0,4.0,40.982845238095194
5472204,1524197877,1524197897,20,245,9.672550603090135,4.0,1.0,54.943421980424745
5472205,1524197896,1524197904,8,226,14.235682019979045,4.0,4.0,62.15725333333332
5472206,1524197899,1524197913,14,201,17.041450602594747,5.0,4.0,91.0
5472207,1524197908,1524197917,9,55,1.905914004058386,1.0,0.6,3.0
5472208,1524197916,1524197920,4,40,36.57119785425444,22.828161089037906,13.33388216461295,100.0
5472209,1524197920,1524197933,13,192,5.4982460456447555,4.0,4.0,8.285791702446257
5472210,1524197928,1524197937,9,225,14.825978435160078,6.765937653414708,1.0,48.21059447519606
5472211,1524197935,1524197945,10,221,10.665940778231999,4.0,4.0,52.14616625828404
5472212,1524197939,1524197953,14,252,4.484358686928611,4.0,4.0,4.0
5472213,1524197944,1524197967,23,225,10.675548776902996,5.0,4.0,32.98572999999988
5472214,1524197962,1524197978,16,225,12.671231759114367,7.8351818769940005,4.0,50.0
5472215,1524197977,1524197998,21,203,11.413199165533381,4.0,4.0,48.025862683877456
5472216,1524197995,1524198043,48,207,25.76257927798761,6.133740595332725,4.0,55.0
5472217,1524198040,1524198080,40,190,30.51608820943772,9.540889884358444,4.0,90.15113223140494
5472218,1524198078,1524198087,9,227,13.765648480094098,5.0,4.0,50.0
5472219,1524198082,1524198101,19,213,10.226610852002116,4.0,1.0,40.63382959037766
5472220,1524198098,1524198108,10,226,11.175679800140445,4.0,4.0,63.27836624112686
5472221,1524198108,1524198119,11,223,12.650260727186808,4.0,4.0,64.051651219782
5472222,1524198119,1524198152,33,205,12.746351343019358,4.99318611236074,4.0,55.0
5472223,1524198151,1524198208,57,238,12.849029380540633,5.822834756097562,1.0,50.09516836016883
5472224,1524198206,1524198247,41,156,13.450931960484187,7.170592962962963,4.0,50.0
5472225,1524198246,1524198259,13,215,49.5003444490852,50.0,18.0,100.0
5472226,1524198258,1524198272,14,169,8.853139966744438,5.0,4.0,23.2442058704157
5472227,1524198269,1524198282,13,175,11.620934671094895,5.0,4.0,51.128720200584944
5472228,1524198281,1524198287,6,189,13.829861573405458,5.941051352757949,4.0,50.0
5472229,1524198284,1524198300,16,183,23.901605013846854,8.0,4.0,91.0
5472230,1524198300,1524198312,12,196,7.660054007839874,4.0,4.0,27.741866820345013
5472231,1524198311,1524198334,23,188,17.650053465572093,5.228507142999928,4.0,57.794051420176295
5472232,1524198335,1524198343,8,207,11.73801783487379,5.0,4.0,41.0
5472233,1524198341,1524198348,7,69,37.470752632051465,20.0,20.0,55.0
5472234,1524198346,1524198368,22,230,17.410478753017276,6.02424347826087,4.0,60.0
5472235,1524198367,1524198376,9,65,8.254260931752656,5.0,4.0,21.07531999999999
5472236,1524198375,1524198393,18,220,9.618371361628887,4.0,4.0,50.0
5472237,1524198391,1524198400,9,206,19.893361963042864,10.0,4.0,50.0
5472238,1524198394,1524198409,15,147,5.358254043959052,4.611276363636363,4.0,7.863194516459755
5472239,1524198408,1524198415,7,150,8.5843727644423,4.0,3.0,50.0
5472240,1524198412,1524198418,6,204,8.89709987634403,5.0,4.0,30.0
5472241,1524198417,1524198425,8,101,7.043372713602668,4.0,4.0,36.11053873377889
5472242,1524198423,1524198445,22,287,4.424365127541248,1.0,1.0,19.25768117647058
5472243,1524198444,1524198452,8,192,13.463684955644482,5.0,4.0,50.0
5472244,1524198450,1524198457,7,215,7.480178367181318,4.0,4.0,24.784919333186192
5472245,1524198455,1524198465,10,203,7.4704821918183235,4.0,4.0,36.19748509803921
5472246,1524198463,1524198474,11,235,9.931041048624083,6.300446666666665,1.0,41.0
5472247,1524198467,1524198482,15,219,7.437628996889946,4.0,4.0,24.064429864253384
5472248,1524198476,1524198545,69,160,23.412932613296714,20.0,4.908512785714286,55.0
5472249,1524198544,1524198562,18,186,28.87632136551622,20.0,5.0,60.0
5472250,1524198560,1524198575,15,186,10.6535418163914,5.0,4.0,50.0
5472251,1524198572,1524198585,13,206,8.597226307850029,4.0,4.0,28.829180909973285
5472252,1524198584,1524198611,27,64,49.561875392403856,50.0,41.0,61.0
5472253,1524198611,1524198626,15,190,11.755183638415375,5.0,4.0,34.480759504511006
5472254,1524198626,1524198645,19,207,20.213221907560623,4.0,4.0,55.0
5472255,1524198644,1524198649,5,250,17.798111922338393,8.0,5.0,55.0
5472256,1524198649,1524198656,7,214,4.84811462979021,4.0,4.0,5.504134630350193
5472260,1524198669,1524198686,17,229,8.546141476638589,4.0,4.0,50.0
5472262,1524198688,1524198706,18,225,4.0,4.0,4.0,4.0
5472266,1524198712,1524198721,9,160,7.088354058939012,4.0,4.0,30.662810012124517
5472267,1524198714,1524198722,8,221,7.378883709426898,4.0,4.0,46.34105899999999
5472269,1524198736,1524198751,15,204,11.106842377660495,5.0,4.0,52.95645082872928
5472270,1524198749,1524198765,16,224,7.031232292863982,4.0,4.0,17.0
5472271,1524198764,1524198780,16,203,15.743917614965808,6.0,4.0,44.51715432534172
5472272,1524198777,1524198793,16,207,18.292087634405313,5.0,4.0,55.0
5472273,1524198793,1524198799,6,157,8.781231980295038,5.0,4.0,34.391028152145815
5472274,1524198799,1524198806,7,265,7.887177252299469,4.0,1.0,44.31503911439115
5472275,1524198804,1524198843,39,194,6.738728515843372,4.0,4.0,14.861100477999258
5472276,1524198843,1524198890,47,162,13.676890466973258,5.0,4.0,55.0
5472277,1524198889,1524198904,15,176,25.552600563775325,20.0,5.0,55.0
5472278,1524198903,1524198923,20,234,7.116320827317768,4.0,1.0,27.736445391191925
5472279,1524198923,1524198937,14,209,8.971614973317337,4.000000000833739,4.0,39.0
5472280,1524198925,1524198960,35,8,46.10909090909091,50.0,25.54054054054054,55.0
5472281,1524198959,1524198962,3,157,19.285637712098588,8.0,4.0,60.0
5472282,1524198961,1524198974,13,204,7.149525201395287,5.0,4.0,15.690701470588225
5472283,1524198973,1524198985,12,37,44.8143089153922,50.0,12.735719314516128,90.0
5472284,1524198985,1524198992,7,195,8.256838007641996,5.0,4.0,30.0
5472285,1524198991,1524199006,15,220,9.332537742109695,4.000000000805709,3.829755172413797,21.98253793454033
5472286,1524199005,1524199023,18,197,16.21899913581373,5.0,4.0,55.0
5472287,1524199023,1524199062,39,228,11.753316365215696,4.0,4.0,55.0
5472288,1524199062,1524199076,14,179,16.414095218195353,5.060502,4.0,55.0
5472289,1524199069,1524199079,10,176,7.544858818240931,5.0,4.0,21.155203743259513
5472291,1524199076,1524199089,13,215,23.135470268257496,7.102023504365727,4.0,112.0
5472292,1524199086,1524199098,12,218,5.40428349574324,4.0,4.0,5.0
5472293,1524199092,1524199105,13,224,10.073930786540629,5.0,4.0,50.0
5472294,1524199102,1524199127,25,202,10.162903172003169,4.0,4.0,38.972931764705834
5472295,1524199124,1524199128,4,232,17.51970435659573,20.0,4.0,39.2512212757459
5472296,1524199128,1524199140,12,180,7.129461062167676,4.0,4.0,21.503438106472856
5472297,1524199135,1524199157,22,238,10.816009958683889,5.0,1.0,50.0
5472298,1524199157,1524199170,13,205,13.614474567671008,7.591214716981132,4.0,50.0
5472299,1524199158,1524199174,16,229,4.471500569100608,4.0,4.0,6.642878892180931
5472300,1524199172,1524199178,6,188,13.472490516368092,5.0,4.0,55.0
5472301,1524199174,1524199209,35,225,5.592101893631626,4.0,4.0,5.0
5472302,1524199208,1524199252,44,191,19.944367970739783,7.479520784313725,4.0,55.0
5472303,1524199252,1524199269,17,243,13.301434726276339,4.8,1.0,50.0
5472304,1524199268,1524199283,15,214,4.470828689444296,1.0,1.0,15.0
5472305,1524199277,1524199284,7,199,7.727953385791639,5.0,4.0,36.77489176278032
5472306,1524199284,1524199293,9,200,22.64875718815298,5.0,4.0,55.0
5472307,1524199289,1524199306,17,91,6.388978536590076,4.0,4.0,23.421742574257323
5472308,1524199304,1524199310,6,225,9.95330744395637,4.0,4.0,39.56049444444434
5472309,1524199310,1524199325,15,224,8.235399922190378,4.0,4.0,47.14488333333329
5472310,1524199318,1524199334,16,216,10.826278018332944,4.0,4.0,49.33176744051178
5472311,1524199329,1524199359,30,211,16.61907858000222,5.0,4.0,51.55712715151515
5472312,1524199357,1524199376,19,174,19.8077599829816,5.6130386640976235,4.0,55.815605595847074
5472313,1524199374,1524199396,22,209,11.820988497024443,4.0,4.0,55.0
5472314,1524199395,1524199438,43,218,23.818850985661342,8.696650895992315,4.0,58.0176368793713
5472315,1524199438,1524199449,11,181,16.081898943813695,8.0,4.0,55.0
5472316,1524199449,1524199478,29,204,9.59822380564754,5.0,4.0,50.0
5472317,1524199477,1524199487,10,228,18.625744025624765,5.785531948073514,4.0,60.0
5472318,1524199487,1524199507,20,187,9.895700490379385,5.0,4.0,48.25802845019598
5472320,1524199513,1524199528,15,211,11.254607058859193,4.019992931207567,4.0,46.16457368421045
5472321,1524199519,1524199540,21,31,38.693867572849825,50.0,0.0,55.0
5472322,1524199528,1524199565,37,169,9.932562824865958,4.0,4.0,35.67632767527672
5472323,1524199566,1524199583,17,52,77.86971753193284,100.0,21.0,100.0
5472324,1524199587,1524199596,9,36,83.40704318590788,100.0,55.0,267.77705695945394
5472325,1524199593,1524199640,47,120,9.076931956127675,4.174858103465528,4.0,28.67990760895965
5472326,1524199639,1524199646,7,248,15.851874133755663,5.271667324726706,1.0,57.14223769305771
5472327,1524199643,1524199659,16,223,7.63394297218069,4.0,4.0,21.673142857142807
5472328,1524199660,1524199681,21,210,13.848846165659264,5.0,4.0,54.44765463917525
5472329,1524199680,1524199689,9,83,42.18254453866702,50.0,20.0,55.0
5472330,1524199686,1524199728,42,160,8.875513725741415,4.0,4.0,17.663216551724133
5472331,1524199728,1524199744,16,87,46.039096298693856,40.321200440528635,20.0,71.02922528185056
5472332,1524199743,1524199748,5,4,54.96279483949437,52.38446473029045,41.0,70.0
5472333,1524199747,1524199772,25,190,7.008436889053953,5.0,4.0,17.920815714285705
5472334,1524199774,1524199794,20,190,10.316742279226684,7.0,4.0,41.0
5472335,1524199794,1524199801,7,176,3.91897861857381,4.0,1.0,4.0
5472336,1524199801,1524199812,11,202,12.552500566124873,5.107931724590164,4.0,41.0
5472337,1524199812,1524199819,7,227,8.176483039289511,4.0,4.0,47.11249289099516
5472338,1524199818,1524199829,11,228,8.536259785421253,4.0,4.0,40.08963130820252
5472339,1524199823,1524199840,17,219,10.165412117790474,8.0,4.0,52.715109994823045
5472340,1524199836,1524199857,21,227,10.880441051023519,4.0,4.0,50.317058971428565
5472341,1524199855,1524199893,38,200,15.6019081241806,5.0,4.0,55.0
5472342,1524199891,1524199902,11,184,19.59409715796519,8.215332626544152,4.0,55.0
5472343,1524199896,1524199935,39,224,9.658471554472536,4.0,1.0,55.0
5472344,1524199935,1524199947,12,136,9.60158233491065,5.0,4.0,41.0
5472345,1524199938,1524199957,19,230,15.078194837964087,5.0,4.0,55.0
5472346,1524199957,1524199965,8,180,9.829442405141382,4.0,4.0,41.613133902960406
5472347,1524199964,1524199972,8,12,45.24156212833001,42.191375,28.248264334929345,55.0
5472348,1524199967,1524199974,7,7,2.341606348829268,0.00017939700000000003,0.0,16.633333333333333
5472349,1524199973,1524199982,9,226,7.705051194307199,4.0,4.0,42.948405263157795
5472351,1524199992,1524199997,5,202,14.29500017837943,4.0,4.0,27.946493226901914
5472352,1524200010,1524200023,13,191,11.785680279345671,6.185528020577756,4.0,50.0
5472353,1524200023,1524200053,30,165,10.873253485197502,5.0,4.0,50.0
5472354,1524200052,1524200061,9,61,20.046453740010225,16.608298564789152,5.818619014841569,47.64231536055617
5472355,1524200055,1524200063,8,238,9.757837356663252,5.0,1.0,50.16820919220698
5472356,1524200062,1524200092,30,223,6.335218595291074,4.0,4.0,23.11344583333333
5472357,1524200092,1524200119,27,201,13.839822600788768,5.0,4.0,50.0
5472358,1524200120,1524200126,6,175,9.890980689095546,4.0,4.0,41.0
5472359,1524200123,1524200131,8,207,12.880072999976099,5.0,1.0,59.7904853594478
5472360,1524200127,1524200173,46,246,8.873122360656907,4.0,1.0,50.0
5472361,1524200173,1524200189,16,204,32.47687955637477,22.23939114391144,5.0,88.22320215608366
5472362,1524200189,1524200193,4,180,11.255417479381915,6.967419764705882,4.0,21.0
5472363,1524200192,1524200202,10,227,5.926462723590187,4.0,4.0,9.694857142857124
5472364,1524200203,1524200216,13,220,6.709231507670339,4.0,4.0,14.814110399999983
5472365,1524200208,1524200225,17,217,8.998995983742926,4.0,4.0,44.9137191666666
5472366,1524200218,1524200250,32,229,12.714301168789977,4.0934110638297865,1.0,49.447763529411695
5472367,1524200249,1524200309,60,190,12.691524111499625,7.584048850835145,4.0,47.05714898198456
5472368,1524200309,1524200343,34,180,20.279589140248973,16.354071065989846,4.0,50.0
5472369,1524200342,1524200353,11,171,12.31660378145472,5.0,4.0,50.0
5472370,1524200352,1524200359,7,74,46.91483766346861,50.0,18.0,60.292864250734574
5472371,1524200357,1524200377,20,52,9.35561448130553,10.0,4.164641145038337,12.223956269962406
5472372,1524200376,1524200388,12,179,18.229740997615146,10.794377078714,4.0,49.90935038390306
5472373,1524200386,1524200395,9,228,6.40818779856917,4.0,4.0,15.782338267032573
5472374,1524200393,1524200435,42,210,13.958304632183328,8.0,4.0,34.836002603708025
5472376,1524200413,1524200447,34,123,13.853456439152426,8.0,4.0,50.0
5472377,1524200423,1524200448,25,164,10.82118544683853,4.0,4.0,46.40756961008463
5472378,1524200426,1524200459,33,211,8.748615944350746,4.0,4.0,55.0
5472379,1524200455,1524200466,11,120,19.815973810351366,11.873824859813084,8.0,51.97398355925117
5472380,1524200463,1524200484,21,318,6.5549614205181275,5.0,1.0,10.0
5472381,1524200483,1524200502,19,254,12.564798394981972,5.0,1.0,48.14478885714277
5472382,1524200500,1524200506,6,111,11.164107873003912,8.0,5.0,50.0
5472383,1524200505,1524200511,6,216,8.627040164269856,4.0,1.0,42.39015474932793
5472384,1524200511,1524200518,7,220,12.418897618024486,5.0,4.0,50.0
5472385,1524200516,1524200531,15,262,6.997675819471449,4.0,4.0,39.698400900900836
5472386,1524200519,1524200540,21,189,32.06969887610791,20.0,4.0,91.0
5472388,1524200530,1524200541,11,199,4.940551912848161,4.0,1.0,5.0
5472389,1524200539,1524200570,31,182,18.289987621360698,5.0,4.0,68.17574637642593
5472390,1524200571,1524200582,11,206,11.677925229244606,5.0,1.0,50.0
5472391,1524200582,1524200599,17,209,8.057664796939195,4.0,4.0,50.317046314775304
5472392,1524200599,1524200628,29,178,13.81759444142344,5.0,4.0,54.107226334242284
5472393,1524200628,1524200644,16,4,112.0,112.0,112.0,112.0
5472394,1524200642,1524200650,8,182,17.831775242433046,8.0,4.0,49.83679824615385
5472395,1524200649,1524200685,36,63,37.84834117376065,30.8688997341412,20.0,55.0
5472396,1524200684,1524200696,12,129,16.85251054964022,8.0,5.0,51.96929968934396
5472397,1524200694,1524201558,864,215,11.934629370461494,4.000000000336518,4.0,44.15344431903269
5472398,1524200706,1524201562,856,158,10.050814735006792,5.0,4.0,39.89067453874538
5472401,1524200757,1524201612,855,195,22.324164445790657,17.0,4.0,55.97820341267754
5472409,1524200869,1524201614,745,50,17.29623929888829,12.257844867884486,5.0,45.437664999999974
5472411,1524200938,1524201615,677,205,14.86404405232845,8.0,4.0,50.0
5472414,1524200980,1524201616,636,207,18.319047387482396,8.788726307692306,4.0,55.0
5472419,1524201039,1524201618,579,145,11.635441074928066,4.0,4.0,51.9
5472424,1524201082,1524201619,537,196,11.542489499874861,4.95721536,4.0,50.0
5472430,1524201219,1524201620,401,141,6.583213468902421,4.49864,4.0,15.0
5472435,1524201307,1524201622,315,195,11.066332291844603,5.0,4.0,50.0
5472442,1524201374,1524201623,249,234,10.472911552388775,5.0,1.0,28.683833424840792
5472448,1524201453,1524201624,171,207,6.511391126127649,4.0,4.0,20.044868818001266
5472453,1524201516,1524201626,110,14,54.32771641640199,50.63220473613662,24.0,99.9383991437365
5472457,1524201592,1524201627,35,191,13.842857973511267,7.58145679245283,4.0,50.0
5472458,1524201612,1524201628,16,227,12.32926664054199,5.0,4.0,21.0
5472462,1524201649,1524201667,18,262,5.97621706270626,4.0,1.0,44.489146938775505
5472464,1524201675,1524201700,25,218,8.24803168517081,4.781681636563564,1.0,52.68239160820804
5472465,1524201701,1524201711,10,153,11.572462575496195,5.0,4.0,40.17155502142334
5472466,1524201710,1524201727,17,229,11.739841317353763,4.0,4.0,57.14113634456078
5472467,1524201725,1524201739,14,177,9.567264682333606,5.0,4.0,50.0
5472468,1524201737,1524201745,8,252,16.470946279115097,5.0,1.0,50.0
5472469,1524201742,1524201764,22,217,5.282758027292709,4.0,4.0,12.737021762107052
5472470,1524201760,1524201788,28,198,17.25458790335722,7.0,4.4,50.0
5472471,1524201787,1524201799,12,31,50.8085664565217,49.137427090505206,20.0,112.0
5472472,1524201799,1524201811,12,211,10.892624039942739,4.0,4.0,55.0
5472473,1524201805,1524201830,25,209,8.90560405645963,4.0,4.0,43.29353142857138
5472474,1524201829,1524201852,23,211,22.690023697593453,17.882933962435587,4.0,55.0
5472475,1524201849,1524201864,15,205,19.77720548025875,5.854176407828283,4.0,66.93095238946673
5472476,1524201861,1524201880,19,199,7.229810652015648,4.0,4.0,30.0
5472477,1524201879,1524201891,12,209,8.867973775012933,4.0,4.0,38.67864132086565
5472478,1524201889,1524201903,14,161,8.283297598972261,5.0,4.0,20.603927328813885
5472479,1524201902,1524201915,13,244,7.251530586327848,4.0,1.0,40.0
5472480,1524201913,1524201922,9,195,12.212693097621628,5.0,4.0,41.0
5472481,1524201922,1524201933,11,208,11.360543566985273,5.0,4.0,30.0
5472482,1524201928,1524201940,12,224,7.969075353783487,4.0,4.0,54.018897140210534
5472483,1524201938,1524201948,10,225,8.459387928940817,4.0,4.0,50.0
5472484,1524201944,1524201977,33,227,9.753547560766966,4.0,4.0,27.478468009918068
5472485,1524201976,1524202004,28,212,11.583978988376867,5.0,4.0,55.0
5472486,1524202003,1524202044,41,189,31.52797860217115,30.0,4.0,55.0
5472487,1524202044,1524202050,6,187,16.650656647733626,5.948457503019324,4.0,60.0
5472488,1524202049,1524202084,35,244,14.973988391234556,4.0,4.0,67.95794742835449
5472489,1524202083,1524202088,5,70,31.913536777952146,22.867032584269662,20.0,55.0
5472490,1524202086,1524202090,4,218,6.078538663377624,5.0,4.0,11.53292161686249
5472491,1524202089,1524202103,14,219,6.45254753663116,4.0,4.0,17.698350657894732
5472492,1524202100,1524202115,15,220,10.289098605944586,5.0,4.0,38.22518999999994
5472493,1524202108,1524202125,17,137,13.947614335829424,18.683509046454766,4.0,23.232524323073363
5472494,1524202124,1524202130,6,194,15.637675295972377,5.0,4.0,50.0
5472495,1524202130,1524202137,7,179,9.42673023847797,7.779026981132076,4.0,23.0
5472496,1524202136,1524202144,8,224,5.406189984876743,4.0,4.0,13.214411627650271
5472497,1524202144,1524202153,9,219,9.67681296427915,4.3830279542566695,1.0,50.0
5472498,1524202152,1524202173,21,158,9.758645221181174,4.0,4.0,20.0
5472499,1524202172,1524202194,22,228,11.11114461856979,5.0,4.0,43.42508233772488
5472500,1524202192,1524202207,15,201,13.121420257887648,7.19634962962963,4.0,44.13007182087022
5472501,1524202198,1524202274,76,225,10.035704909425046,4.0,4.0,38.96280442804428
5472502,1524202273,1524202289,16,232,30.853471843281945,20.0,7.929741454676217,91.0
5472503,1524202285,1524202291,6,226,11.805944185341367,6.561641095890412,5.0,28.944781463414625
5472504,1524202291,1524202297,6,242,5.985153253194608,5.0,4.0,5.0
5472505,1524202297,1524202334,37,223,13.454380250792754,5.0,4.0,50.0
5472506,1524202333,1524202342,9,167,14.844257834992195,5.0,4.0,55.0
5472507,1524202335,1524202347,12,219,4.892677991629309,4.0,4.0,5.556314396887159
5472508,1524202344,1524202376,32,219,6.612535621268842,4.0,4.0,13.90091907713498
5472509,1524202375,1524202389,14,174,12.453027348911693,4.90625,4.0,50.0
5472510,1524202385,1524202395,10,207,13.029359927022572,5.0,4.0,55.0
5472511,1524202394,1524202400,6,6,1.3422306666842105,7.293878571428573e-05,0.0,15.640027230479994
5472512,1524202401,1524202421,20,225,8.86936551786157,4.0,4.0,41.0
5472513,1524202413,1524202430,17,209,10.000658447516214,5.0,4.0,23.36406165239528
5472514,1524202419,1524202438,19,182,6.786532230324387,4.0,4.0,25.500717712177057
5472515,1524202437,1524202445,8,230,10.278321290384428,5.0,4.0,20.0
5472516,1524202441,1524202455,14,4,25.0,18.0,18.0,55.0
5472517,1524202445,1524202474,29,212,11.34792457228645,5.0,4.0,55.0
5472518,1524202473,1524202520,47,178,16.325726624582906,7.994852344589,4.0,50.0
5472519,1524202518,1524202524,6,222,23.441671560388016,10.0,4.0,60.0
5472520,1524202522,1524202541,19,220,6.526082260693375,4.0,4.0,19.115711303814333
5472521,1524202541,1524202558,17,224,11.165166439577789,4.8508886538461535,4.0,41.0
5472522,1524202556,1524202566,10,198,17.757244629123395,7.465188561797085,4.0,55.0
5472523,1524202561,1524202569,8,264,4.442871602508388,4.0,1.0,14.012989563468626
5472524,1524202568,1524202592,24,218,9.434932985910434,4.0,4.0,40.33766531423611
5472525,1524202589,1524202603,14,211,17.741322127974364,6.0,4.0,50.0
5472526,1524202602,1524202626,24,200,7.391549208079584,5.0,4.0,35.98695999999989
5472527,1524202627,1524202639,12,192,12.323216003546266,4.0,4.0,51.63954356846471
5472528,1524202631,1524202655,24,241,5.674184320714658,4.0,1.0,18.182682004952692
5472531,1524202665,1524202675,10,218,7.351029163166166,4.0,4.0,31.210314412856892
5472532,1524202668,1524202683,15,219,14.139985661790003,4.0,4.0,50.0
5472533,1524202683,1524202691,8,207,11.123142926899469,5.0,4.0,54.3446446071018
5472534,1524202689,1524202700,11,223,19.740518965466553,5.0,1.0,50.0
5472535,1524202693,1524202713,20,222,8.663967517238106,4.0,4.0,55.0
5472536,1524202703,1524202725,22,174,5.696470701377134,4.0,4.0,6.820661899021212
5472537,1524202725,1524202743,18,199,12.41698072011011,5.0,4.0,51.72575127941176
5472538,1524202742,1524202749,7,216,11.952288302274967,4.0,4.0,55.0
5472539,1524202748,1524202775,27,200,4.05799122523959,4.0,4.0,5.0
5472540,1524202774,1524202798,24,227,14.821156852177056,8.195259494224924,4.0,41.0
5472543,1524202791,1524202800,9,227,6.088891425196342,4.0,4.0,18.546803558802722
5472544,1524202799,1524202816,17,219,8.02501257766739,4.0,4.0,51.30816078418404
5472545,1524202806,1524202828,22,232,5.438462269552075,4.0,4.0,4.456684918691356
5472546,1524202822,1524202839,17,205,11.357828860698687,5.0,4.0,41.0
5472547,1524202833,1524202870,37,206,20.289071839368788,8.865502039896583,4.0,55.28979390415754
5472548,1524202866,1524202886,20,128,11.929097836664871,5.200024173901946,4.0,50.0
5472549,1524202885,1524202896,11,42,39.38750272513333,42.21563317855294,8.94136612069576,49.77234608679103
5472550,1524202895,1524202901,6,179,6.8505482661721535,5.0,4.0,10.621184155299984
5472551,1524202900,1524202934,34,225,6.264860920995853,4.0,4.0,16.045680776270597
5472552,1524202931,1524202971,40,241,13.98495274142604,7.814751200345459,1.0,55.0
5472553,1524202970,1524202990,20,245,11.339576658550452,5.0,1.0,50.0
5472554,1524202991,1524203017,26,44,12.854023292112123,9.76195059625213,1.0,51.753173701765476
5472555,1524203015,1524203025,10,189,11.373453934377526,5.0,1.0,37.81011402214019
5472556,1524203024,1524203031,7,204,14.279417790361736,4.0,4.0,55.0
5472557,1524203026,1524203039,13,228,5.855307154658835,4.0,4.0,16.89179179687499
5472558,1524203036,1524203050,14,225,7.827584755779208,4.0,1.0,36.28218074048792
5472559,1524203043,1524203061,18,227,6.286316777624265,4.0,4.0,16.052134099766167
5472560,1524203050,1524203072,22,196,16.638870563131903,7.991060203846154,1.0,55.0
5472561,1524203057,1524203073,16,213,9.417396998846433,4.0,4.0,50.0
5472562,1524203071,1524203097,26,100,14.455822636702841,5.0,5.0,50.490197828571425
5472563,1524203096,1524203115,19,191,14.725802537913086,5.0,4.0,57.56514026487131
5472564,1524203115,1524203127,12,211,22.558902408793355,7.123482403700378,4.0,100.0
5472565,1524203125,1524203147,22,222,9.32383957066831,4.0,4.0,32.93246125461253
5472566,1524203147,1524203160,13,190,13.828411734355633,5.0,1.0,55.0
5472567,1524203153,1524203167,14,13,12.53722500292557,0.000313632,0.0,68.6847005208333
5472568,1524203158,1524203175,17,211,8.568038257738348,4.239128019559902,4.0,24.0
5472569,1524203173,1524203181,8,227,13.120053843119393,5.0,4.0,43.45579057258802
5472570,1524203177,1524203194,17,1,0.000288986,0.000288986,0.000288986,0.000288986
5472571,1524203193,1524203210,17,211,15.305248827874136,8.143751513243409,4.0,48.26084309518532
5472572,1524203208,1524203221,13,214,13.306345251169391,4.376277119999998,4.0,61.04984464944634
5472573,1524203214,1524203267,53,216,6.532920151276351,4.0,4.0,21.372076018099524
5472574,1524203265,1524203289,24,183,16.904609317482265,8.0,4.0,60.0
5472575,1524203288,1524203300,12,117,13.384990669891005,5.0740903765611,4.0,50.0
5472576,1524203298,1524203305,7,192,7.634236831842469,4.0,4.0,30.0
5472577,1524203305,1524203316,11,218,9.06277560686187,4.0,1.0,50.28059443633897
5472578,1524203311,1524203327,16,103,15.334355462773681,5.0,5.0,55.0
5472579,1524203323,1524203329,6,119,7.237123302161511,5.0,4.0,14.398220595143195
5472580,1524203329,1524203337,8,169,7.492548212371723,4.0,4.0,41.0
5472581,1524203337,1524203356,19,111,11.052314756167933,5.0,4.0,50.0
5472582,1524203347,1524203389,42,218,7.636722699807638,4.0,4.0,34.43679238593489
5472583,1524203390,1524203412,22,116,18.943646804601673,8.105511708535909,5.0,55.64379298176007
5472584,1524203398,1524203427,29,216,4.006590089729533,4.0,4.0,4.066359357065276
5472585,1524203426,1524203449,23,228,11.240432568387732,5.0,1.0,54.13522900747653
5472586,1524203449,1524203456,7,44,20.864839601326462,20.0,5.0,51.76284201983345
5472587,1524203456,1524203469,13,118,10.405962320935025,5.0,5.0,55.0
5472588,1524203469,1524203476,7,95,15.16328779351629,5.0,5.0,50.0
5472589,1524203476,1524203485,9,213,6.093585249459206,4.000000000003549,4.0,14.456988774961756
5472591,1524203489,1524203500,11,222,6.113959817611939,4.0,4.0,16.210471628874256
5472592,1524203496,1524203509,13,6,10.342494051391423,0.00016093768123333336,0.0,55.0
5472594,1524203503,1524203510,7,19,7.3205002193247255,5.046531094214876,5.0,13.630797870569447
5472595,1524203509,1524203529,20,203,7.0610249188172505,4.0,4.0,22.08617837837836
5472596,1524203529,1524203544,15,207,14.775351553464986,8.0,4.0,44.78420056624186
5472597,1524203543,1524203550,7,163,12.869792168987722,5.0,4.0,49.45132509526885
5472598,1524203551,1524203619,68,156,14.089814486410507,6.346676778858107,4.0,28.025485611355506
5472599,1524203620,1524203631,11,140,20.985857454279135,10.026400267173926,5.0,60.0756860920666
5472600,1524203628,1524203682,54,108,11.190357770401475,5.0,4.0,23.72026473333333
5472601,1524203680,1524203689,9,199,28.566190038949667,18.78511724137931,5.0,55.0
5472602,1524203687,1524203691,4,175,12.822708764355129,4.0,4.0,50.0
5472603,1524203689,1524203722,33,225,4.804488848665223,4.0,4.0,9.735919729729723
5472604,1524203721,1524203733,12,202,10.909133014384677,4.0,4.0,41.0
5472606,1524203734,1524203739,5,228,9.154706470243095,4.0,4.0,50.0
5472607,1524203739,1524203763,24,88,2.9065682574425247,1.0,1.0,1.0
5472608,1524203763,1524203774,11,274,8.42952544809556,4.970062340425532,1.0,46.42798135762056
5472609,1524203771,1524203779,8,222,9.777433434462026,4.0,4.0,70.96789702272724
5472610,1524203778,1524203794,16,238,7.968236799348483,4.0,4.0,40.53496428571427
5472611,1524203782,1524203804,22,235,6.20778944708763,4.0,4.0,19.505215384615337
5472612,1524203794,1524203818,24,54,26.587078707940552,28.75653766278892,1.0,88.58758074694506
5472613,1524203799,1524203822,23,176,15.053748277633852,7.910545942204462,4.0,41.0
5472614,1524203819,1524203836,17,180,19.002361394133818,8.0,4.0,60.0
5472615,1524203824,1524203847,23,219,9.024144318140348,4.0,4.0,55.0
5472616,1524203837,1524203866,29,221,14.940165294354665,5.029433000000001,4.0,50.0
5472617,1524203861,1524203882,21,218,12.321998387872213,5.282420195893796,4.0,50.53176688461537
5472618,1524203870,1524203887,17,231,5.41343756192406,4.0,4.0,10.640895574857137
5472619,1524203886,1524203901,15,213,6.3928563447334525,4.0,4.0,14.477641770475469
5472620,1524203900,1524203928,28,275,11.74632594061631,4.0,4.0,41.0
5472621,1524203928,1524203952,24,168,16.359867738599373,8.539860006662106,4.0,50.0
5472622,1524203950,1524203961,11,226,15.603648730975753,5.0,4.0,55.0
5472623,1524203958,1524203974,16,125,46.6799972706835,39.0,28.18979411764707,100.0
5472624,1524203967,1524203976,9,88,12.132381243402454,7.087017777777778,1.0,48.95740667928814
5472625,1524203971,1524203994,23,67,4.01102670722305,4.0,4.0,4.0
5472626,1524203992,1524204002,10,42,8.272909100376753,5.0,4.0,40.0
5472627,1524204005,1524204012,7,174,11.000062376485438,4.0,4.0,41.0
5472628,1524204010,1524204024,14,117,6.4489601893239055,5.0,4.0,9.727777960708185
5472629,1524204020,1524204042,22,25,26.016461483228483,21.0,0.0,56.75272009671451
5472630,1524204042,1524204070,28,259,19.87003307194884,8.027169340914659,5.0,55.0
5472631,1524204070,1524204085,15,190,18.521434272888694,8.738068683880003,4.0,59.71802768465259
5472632,1524204095,1524204103,8,264,10.024187490692432,5.0,4.1,55.0
5472633,1524204102,1524204110,8,225,8.468552750186435,4.0,4.0,20.935367164835164
5472634,1524204108,1524204130,22,68,7.394818591261972,5.0,4.0,20.60346904761903
5472635,1524204129,1524204146,17,270,7.449373639076989,4.0,1.0,40.14812249999999
5472636,1524204146,1524204155,9,39,33.25176161128038,20.994797262297322,20.0,100.0
5472637,1524204156,1524204172,16,197,8.803007831862377,5.0,4.0,30.64757984205635
5472638,1524204172,1524204185,13,258,6.943534602172035,4.0,4.0,24.430317931034413
5472639,1524204184,1524204194,10,45,36.38791715001001,43.030142890134464,20.0,55.0
5472640,1524204192,1524204202,10,255,5.875093456334622,4.0,1.0,11.476133617889205
5472641,1524204201,1524204219,18,253,9.955847275458817,4.0,4.0,32.1400318307766
5472642,1524204217,1524204253,36,296,7.427262244934842,4.0,4.0,20.0
5472643,1524204271,1524204276,5,193,27.817101597969014,18.630353466408952,5.0,55.0
5472644,1524204276,1524204281,5,5,21.002825839827977,20.274514250736026,13.054646897108805,40.45649112116451
5472645,1524204281,1524204296,15,25,9.203359398683936,5.079710712463364,4.8,51.392463685220726
5472646,1524204296,1524204307,11,287,10.129310293468533,4.0,4.0,54.37109562
5472647,1524204307,1524204325,18,267,7.8183990613618,4.0,4.0,20.0
5472648,1524204325,1524204331,6,244,7.355899646105405,4.0,4.0,27.567004285714265
5472649,1524204332,1524204339,7,329,11.284399189529363,4.1,4.1,55.0
5472650,1524204337,1524204347,10,52,6.46990508730598,4.967207015226328,4.0,14.3983972686645
5472651,1524204345,1524204356,11,249,6.564846684066998,4.0,4.0,19.371885977802926
5472652,1524204355,1524204361,6,223,4.654189033762939,4.0,4.0,4.0
5472653,1524204361,1524204380,19,153,10.655923846359828,4.760039785140906,4.0,40.0
5472654,1524204369,1524204395,26,109,23.720642642476186,12.228972421048494,4.0,55.0
5472655,1524204394,1524204419,25,75,25.059654082332866,20.0,4.0,55.0
5472656,1524204418,1524204451,33,254,4.803100194943363,4.0,4.0,5.0
5472657,1524204453,1524204476,23,165,15.615592753859287,8.0,4.0,50.47654053008527
5472658,1524204476,1524204495,19,159,25.40506851528131,9.310000001,1.0,54.11785585595131
5472659,1524204495,1524204501,6,122,10.198835791392629,6.0,1.0,40.07806753246753
5472660,1524204503,1524204508,5,213,26.617492250793315,12.814809843080674,5.0,91.0
5472661,1524204523,1524204533,10,244,12.424708663183855,5.242548815566836,4.1,49.67422882164175
5472662,1524204532,1524204563,31,260,4.964385177077392,4.0,1.0,17.0
5472663,1524204565,1524204577,12,219,11.64490737958365,4.0,4.0,41.0
5472664,1524204579,1524204586,7,317,8.584263389519633,4.1,4.1,20.0
5472665,1524204585,1524204606,21,239,15.163226117361644,4.0,4.0,52.717787362325176
5472666,1524204605,1524204621,16,205,10.438244140605889,4.1225262116826045,4.0,29.737722943722712
5472667,1524204620,1524204632,12,271,10.889819015439285,4.1,4.1,55.0
5472668,1524204631,1524204645,14,47,8.686982976989839,7.355216354120604,4.0,23.361226749604768
5472669,1524204644,1524204654,10,192,10.902579892206182,4.99009537037037,4.0,45.698847058823475
5472670,1524204655,1524204705,50,270,11.505216883705815,4.1,4.1,55.0
5472671,1524204705,1524204723,18,173,15.687707715898549,8.0,4.0,50.0
5472672,1524204723,1524204732,9,243,17.55678186630824,5.0,4.1,55.0
5472673,1524204729,1524204742,13,216,5.640891578125264,4.253194546201351,4.0,7.801649848476737
5472674,1524204741,1524204766,25,248,4.6356670077894915,4.0,4.0,8.49827937984496
5472675,1524204758,1524204780,22,258,12.140062747388143,4.0,4.0,41.0
5472676,1524204779,1524204796,17,174,12.061459962704577,5.0,4.0,50.0
5472677,1524204796,1524204815,19,294,9.826797045179674,4.1,4.1,50.35000564096778
5472678,1524204813,1524204829,16,207,10.326936143960161,8.0,4.0,20.36612653864118
5472679,1524204828,1524204852,24,342,7.148827846682086,4.1,4.1,21.0
5472680,1524204835,1524204853,18,243,4.696590230144709,4.0,4.0,4.9929490181888685
5472681,1524204841,1524204870,29,54,5.033369290122893,5.0,4.0,18.211474383789866
5472682,1524204870,1524204883,13,204,22.59465981744042,9.638784375000002,4.0,74.16953771112583
5472683,1524204876,1524204900,24,189,33.70982317940628,14.075820312500017,4.0,100.0
5472684,1524204900,1524204911,11,213,12.13459508300797,4.025681429314615,4.0,82.47365765765711
5472685,1524204910,1524204923,13,288,22.348921189941848,5.0,4.1,100.0
5472686,1524204923,1524204938,15,214,12.856659008430054,4.0,1.0,64.50365182967862
5472687,1524204937,1524205004,67,198,13.053150408409703,5.0,1.0,55.0
5472688,1524205004,1524205018,14,208,53.21676295261536,50.0,12.994150967741936,100.0
5472689,1524205010,1524205025,15,201,9.821974723410369,5.2482993061973335,4.0,30.434702899160744
5472690,1524205020,1524205034,14,235,6.5937255262357555,4.0,1.0,10.0
5472691,1524205032,1524205051,19,204,10.916140951537757,4.0,4.0,73.83649879558554
5472692,1524205050,1524205061,11,184,13.352054988297725,5.0,4.0,50.0
5472693,1524205060,1524205069,9,280,11.52464981333836,4.1,4.1,50.0
5472694,1524205070,1524205109,39,270,7.6122204777484175,4.1,4.0,20.0
5472695,1524205109,1524205121,12,238,17.217094040628478,7.8879721744428,1.0,85.80680748070303
5472696,1524205120,1524205134,14,220,9.902210428904201,4.0,4.0,50.0
5472697,1524205129,1524205157,28,189,13.82246817259528,4.0,4.0,100.0
5472698,1524205141,1524205177,36,336,6.069395426224392,4.1,4.1,11.82539435657151
5472699,1524205175,1524205184,9,178,18.570693572043012,7.5665317916184,4.0,100.0
5472700,1524205183,1524205213,30,215,11.685978103934456,4.0,4.0,50.0
5472701,1524205214,1524205235,21,62,46.213653124506294,41.0,0.0,100.0
5472702,1524205233,1524205238,5,183,11.696693223164669,5.0,4.0,53.723276568265646
5472703,1524205237,1524205253,16,216,10.440110355463249,4.0,4.0,23.813355103926096
5472704,1524205251,1524205263,12,291,19.852221376355224,6.0,4.1,100.0
5472705,1524205256,1524205281,25,181,7.923890292987095,4.0,4.0,44.12676765957441
5472706,1524205283,1524205300,17,39,35.21284362180828,32.73988620812238,20.0,55.0
5472707,1524205293,1524205302,9,184,7.422819726154486,4.0,4.0,37.90704144144114
5472708,1524205300,1524205305,5,224,6.732082105625722,4.9462662597380005,4.1,12.0
5472709,1524205304,1524205329,25,239,7.63619674527665,4.0,4.0,21.492676244909266
5472710,1524205327,1524205344,17,192,9.633017304339997,5.213069702970297,4.0,46.998599999999946
5472711,1524205344,1524205370,26,175,10.85208339444643,5.0,4.0,50.0
5472712,1524205370,1524205390,20,228,12.834892393768135,5.682313734567902,1.0,50.0
5472713,1524205387,1524205437,50,193,11.422600125580388,4.1,4.0,51.602201599999994
5472714,1524205437,1524205455,18,320,14.268216023805559,1.0,1.0,58.8481708185185
5472715,1524205449,1524205476,27,253,12.931009657520146,8.0,4.1,52.28565311203314
5472716,1524205476,1524205493,17,179,13.564061861227161,5.0,4.0,50.0
5472718,1524205497,1524205514,17,217,5.400955375449307,4.0,4.0,15.0
5472719,1524205507,1524205535,28,255,9.241382545535204,4.0,4.0,50.0
5472720,1524205535,1524205546,11,219,10.131156485411257,4.0,4.0,41.0
5472721,1524205542,1524205552,10,341,6.424506295518555,4.1,4.1,19.210669439013873
5472722,1524205550,1524205555,5,134,5.3131583793993995,4.0,4.0,7.7128917754240405
5472723,1524205553,1524205569,16,370,4.965617822336163,4.1,4.1,8.243458543178802
5472724,1524205566,1524205603,37,212,9.73321632046831,4.644846558828399,4.0,20.0
5472725,1524205603,1524205649,46,243,11.251233144656522,8.0,1.0,40.0
5472726,1524205648,1524205661,13,180,14.879823584856068,6.8700697157118125,4.0,50.0
5472727,1524205653,1524205673,20,213,8.411407463476571,4.0,4.0,50.0
5472729,1524205673,1524205701,28,218,6.885378195736172,4.0,4.0,23.0
5472730,1524205677,1524205713,36,214,9.621050420467377,4.0,4.0,44.68439577851984
5472731,1524205681,1524205750,69,231,10.896751973455741,4.0,4.0,50.89938414587331
5472732,1524205699,1524205777,78,207,9.387446746034492,4.431347333730664,4.0,49.52248926452333
5472733,1524205757,1524205779,22,164,18.62014789792939,8.50897322363496,4.000000000412256,69.32076306306304
5472734,1524205783,1524205810,27,171,10.834273055334648,4.0,4.0,40.00004862247278
5472735,1524205807,1524205815,8,146,16.18145573567046,8.027379984753683,4.0,50.0
5472736,1524205814,1524205828,14,219,10.98180927126642,5.0,1.0,50.0
5472737,1524205826,1524205837,11,281,7.6009907143082005,4.928032169117648,4.0,29.05355560546875
5472738,1524205833,1524205850,17,215,20.485458821806546,5.792223821174121,4.1,62.50436687158524
5472739,1524205848,1524205857,9,256,10.445192650651558,5.0,1.0,48.621979610467726
5472740,1524205856,1524205885,29,189,6.304206665827113,4.446565843663281,4.0,12.489600884439408
5472741,1524205881,1524205917,36,221,13.076758740188898,5.0,1.0,44.636452363636295
5472742,1524205914,1524205940,26,188,15.056485948406994,5.8239113892037615,4.93782092548077,50.31509737403443
5472743,1524205937,1524205947,10,216,12.599526200048832,5.0,4.0,54.723941964285686
5472744,1524205942,1524205966,24,219,4.73601044782391,4.0,4.0,4.0
5472745,1524205946,1524205967,21,295,15.845795058569815,4.1,4.1,55.0
5472746,1524205959,1524206004,45,209,10.325036205761322,4.0,4.0,41.225183257918516
5472747,1524205968,1524206023,55,6,23.07827802063578,22.169061669981208,0.0,51.452380952380935
5472749,1524205998,1524206032,34,195,17.089854770644106,6.0,4.0,59.19125529194899
5472750,1524206002,1524206058,56,147,9.65400780472303,5.0,4.0,32.76114454562095
5472751,1524206044,1524206066,22,188,17.626805267228338,12.610000001,5.0,54.10985543329468
5472752,1524206067,1524206082,15,196,12.664185876683622,5.0,4.0,50.0
5472753,1524206081,1524206102,21,209,11.7335762269201,5.0,4.0,46.58451578947346
5472756,1524206110,1524206125,15,213,11.307921415895878,4.0,4.0,50.0
5472758,1524206125,1524206180,55,213,17.157555242357716,4.0,4.0,55.0
5472761,1524206171,1524206181,10,222,12.626352413647258,5.0,4.0,55.0
5472764,1524206233,1524206250,17,225,9.319576951862649,4.0,4.0,50.87124599999999
5472766,1524206254,1524206303,49,201,15.115159172278275,7.579154734411085,4.0,50.0
5472768,1524206279,1524206304,25,224,5.127985401608544,4.0,4.0,7.227230231884057
5472769,1524206284,1524206367,83,214,14.213863900616603,5.0,4.0,42.549202133912175
5472772,1524206336,1524206369,33,335,8.731028272497484,4.1,4.1,20.658013930695365
5472775,1524206358,1524206370,12,16,28.551332689083264,20.392557339449542,20.0,53.191784813301254
5472776,1524206367,1524206434,67,201,8.592668280415685,4.0,4.0,39.03789184040637
5472779,1524206397,1524206435,38,222,11.261663070732371,5.0,4.0,35.0
5472782,1524206452,1524206486,34,217,10.535813234727286,5.0,4.0,21.0
5472783,1524206474,1524206537,63,206,11.566177824925536,5.0,4.0,56.86737414299705
5472786,1524206506,1524206559,53,10,14.008347217611256,0.00017955529992380955,0.0,57.53771948043648
5472788,1524206553,1524206560,7,224,16.735305608056276,6.0,4.0,59.3320559781774
5472789,1524206558,1524206603,45,226,13.59258978426721,5.0,1.0,65.83483422717153
5472793,1524206596,1524206654,58,160,8.849823430568627,4.0,4.0,50.0
5472794,1524206606,1524206656,50,328,8.815439780874804,4.1,4.1,30.0
5472796,1524206620,1524206657,37,206,7.54559528394542,4.0,4.0,16.0
5472799,1524206672,1524206724,52,0,0,0,0,0
5472800,1524206695,1524206755,60,148,12.699348920046885,8.0,5.0,50.84466887966799
5472801,1524206753,1524206763,10,344,16.945707625376773,4.1,4.1,66.0
5472802,1524206760,1524206791,31,115,9.477095548654328,5.0,5.0,20.0
5472803,1524206789,1524206810,21,160,12.527839204453054,5.0,4.0,51.99700672461862
5472804,1524206809,1524206821,12,196,9.086383876571867,4.0,4.0,33.85774142895419
5472805,1524206815,1524206832,17,23,52.3895701324261,50.0,24.63785827794597,96.41101288580792
5472806,1524206822,1524206840,18,302,7.853368902870313,4.1,4.1,18.0
5472807,1524206838,1524206847,9,319,8.305305148527141,4.1,4.1,39.60074561403503
5472808,1524206844,1524206862,18,228,6.777289049605682,4.0,4.0,20.804408536585363
5472809,1524206860,1524206896,36,98,12.214605724043075,8.462563725187884,4.0,48.683000816245716
5472810,1524206896,1524206920,24,155,13.270327594028108,5.284281124497994,4.0,50.0
5472811,1524206920,1524206924,4,122,9.75136231012756,5.0,4.0,30.940824399038444
5472812,1524206923,1524206933,10,205,8.225444660430925,4.0,4.0,50.87788029100526
5472813,1524206930,1524206957,27,319,11.504983669494234,4.1,4.1,55.0
5472815,1524206939,1524206959,20,226,4.118998443915585,4.0,4.0,5.0
5472816,1524206948,1524206967,19,216,5.6106579408622785,4.0,4.0,20.0
5472817,1524206951,1524207023,72,226,4.67157074988951,4.0,4.0,8.1267584835204
5472819,1524207029,1524207043,14,214,11.955951795557924,4.0,4.0,54.909541071428556
5472820,1524207038,1524207071,33,248,9.721061223159422,4.0,1.0,50.0
5472821,1524207045,1524207090,45,233,7.274300587998187,4.0,1.0,24.0
5472824,1524207072,1524207106,34,123,10.661589849617842,5.270279112647282,4.0,55.0
5472825,1524207082,1524207107,25,129,13.271600841568814,5.706732527836435,4.0,30.0
5472828,1524207115,1524207128,13,213,12.90099683134593,5.0,4.0,55.0
5472830,1524207147,1524207156,9,211,8.249722005905744,4.0,4.0,30.0
5472831,1524207155,1524207183,28,204,12.103385568960999,4.0,4.0,55.0
5472832,1524207174,1524207203,29,213,6.878905653049938,4.0,4.0,19.08537879624796
5472834,1524207207,1524207215,8,203,14.864581526686049,5.0,4.0,50.0
5472835,1524207214,1524207239,25,203,6.1424207444051,4.0,4.0,17.783499999999954
5472836,1524207225,1524207253,28,189,12.134428499344006,5.0,4.0,50.0
5472837,1524207234,1524207254,20,135,11.738339699712895,4.0,4.0,45.4342310771463
5472839,1524207250,1524207277,27,223,8.717781891208773,4.0,4.0,32.20502183855234
5472840,1524207265,1524207298,33,212,8.72685612728406,4.0,4.0,36.16371029411763
5472841,1524207296,1524207319,23,211,24.29702768124887,10.0,6.0,55.0
5472842,1524207310,1524207323,13,188,10.490766617741452,5.0,4.0,20.0
5472843,1524207321,1524207369,48,124,27.798228628588618,14.864654280925722,4.0,91.0
5472844,1524207369,1524207397,28,188,13.742662221458085,5.0,4.0,50.04056926704793
5472845,1524207396,1524207409,13,229,13.176976387743663,5.0,4.1,55.0
5472846,1524207401,1524207415,14,127,8.571679456244006,4.0,4.0,52.16990686740178
5472847,1524207416,1524207430,14,200,10.849460697079937,4.732543302419155,1.0,53.3135156093438
5472848,1524207428,1524207446,18,221,5.933904962462491,4.0,4.0,20.0
5472849,1524207444,1524207459,15,252,17.745804718496316,6.383802851182198,4.1,50.0
5472850,1524207454,1524207480,26,215,6.589721605073231,4.0,4.0,12.5255094860465
5472851,1524207480,1524207537,57,157,20.49259091759623,7.0,4.0,90.0
5472852,1524207536,1524207613,77,157,15.864573738380466,8.0,4.1,50.0
5472853,1524207612,1524207622,10,123,36.07852814491097,24.0,15.0,87.01430873291521
5472854,1524207621,1524207627,6,243,10.042829964310876,5.0,4.0,21.614625470653376
5472855,1524207626,1524207680,54,113,13.762912420569293,7.175126497709058,5.0,48.32376015779231
5472856,1524207679,1524207690,11,246,16.587189226060836,9.744695724315926,1.0,50.0
5472857,1524207689,1524207706,17,198,13.499240513279593,8.0,5.0,50.0
5472858,1524207704,1524207726,22,289,10.730656670539712,4.1,4.1,50.0
5472859,1524207725,1524207754,29,131,10.399486513995699,5.0,4.0,40.76105508659142
5472860,1524207753,1524207769,16,80,15.348669101375283,10.0,4.91162630787037,41.0
5472861,1524207769,1524207788,19,198,24.65143313673456,5.612506670302899,4.0,54.87489546552274
5472862,1524207786,1524207823,37,181,27.36732807043791,20.0,4.0,54.57790587407822
5472863,1524207822,1524207837,15,205,23.008132082955104,10.000000004946363,5.0,55.0
5472864,1524207837,1524207860,23,148,21.54857720528137,12.217548550324095,5.0,54.63002094162242
5472865,1524207860,1524207879,19,201,11.176482342762174,5.0,4.0,50.0
5472866,1524207878,1524207922,44,69,31.564874120099233,20.0,0.0,106.61169777777768
5472867,1524207922,1524207943,21,152,14.207977743747284,5.0,5.0,55.0
5472868,1524207942,1524207950,8,224,12.901072509316014,5.0,1.0,52.38457289913524
5472869,1524207949,1524207990,41,366,1.9428852552011249,1.0,1.0,1.0
5472870,1524207989,1524207995,6,160,17.25772244323446,5.0,5.0,55.0
5472871,1524207994,1524208001,7,230,7.854409561018695,4.1,4.0,20.625486716037955
5472872,1524208002,1524208031,29,194,6.712505580802507,4.0,4.0,12.521542633906387
5472873,1524208032,1524208046,14,214,20.875953726602127,5.0,1.0,91.0
5472874,1524208044,1524208070,26,54,26.710243259643057,5.0,1.028833913043478,53.85228307966544
5472875,1524208070,1524208078,8,46,37.18923740322834,50.16047536928387,2.8211915558132628,54.954360579529734
5472876,1524208077,1524208101,24,233,9.674651920105033,5.0,4.0,21.78657215630438
5472877,1524208100,1524208107,7,35,44.731755128723975,41.0,0.000143808,109.43391143911433
5472878,1524208106,1524208123,17,9,50.97924474514922,57.01818536585366,15.04263672038073,74.44634968486487
5472879,1524208122,1524208140,18,228,11.100472672539674,5.0,3.3184479704483696,46.73910049999995
5472880,1524208140,1524208144,4,124,22.82087496757089,5.0,4.0,54.63454762472627
5472881,1524208145,1524208150,5,155,6.680031771420697,5.0,4.0,13.641183787921651
5472882,1524208149,1524208167,18,239,8.10144734605329,5.0,4.1,50.0
5472883,1524208167,1524208179,12,180,13.336659087617416,8.000339942512177,4.0,40.57620527739363
5472884,1524208178,1524208213,35,206,10.301835504040552,4.0,4.0,42.08939511104187
5472885,1524208214,1524208225,11,167,14.978200782545015,6.276736920229733,4.0,41.0
5472886,1524208219,1524208228,9,314,6.404337350045572,4.1,4.1,15.767702631578933
5472887,1524208227,1524208266,39,228,4.621396855840027,4.0,1.0,5.0
5472888,1524208266,1524208288,22,177,18.796726230777445,8.041523622899794,1.0,60.0
5472889,1524208287,1524208298,11,156,11.849398292455293,5.0,4.0,55.306122142857134
5472890,1524208297,1524208307,10,144,22.096796631727305,8.0,5.0,54.43495551658405
5472891,1524208306,1524208314,8,25,22.301260398409454,20.0,5.0,40.918315737518164
5472892,1524208312,1524208334,22,25,11.182695063602614,5.0,1.0,44.62395423756407
5472893,1524208334,1524208349,15,174,14.367354392189524,4.9950957175925925,4.0,50.06182783075375
5472894,1524208349,1524208372,23,43,13.060364317107473,8.0,5.0,41.0
5472895,1524208373,1524208419,46,173,15.604226944399814,5.860277539378844,4.0,50.0
5472896,1524208417,1524208433,16,190,12.22689887037844,5.0,4.0,49.89277449650287
5472897,1524208432,1524208445,13,171,11.151209540900862,4.0,4.0,40.9242357644312
5472898,1524208443,1524208455,12,200,9.657529138845367,5.0,4.0,46.23416089036869
5472899,1524208454,1524208468,14,162,19.519508557489484,7.659709777777778,5.0,55.92426591576884
5472900,1524208461,1524208493,32,171,6.210065831623695,4.0,4.0,20.87335604384553
5472901,1524208493,1524208519,26,247,16.730732055532535,5.103066231004612,4.1,59.48135580601027
5472902,1524208519,1524208529,10,113,16.16107545929436,8.2,5.0,60.0
5472903,1524208529,1524208538,9,243,7.601224475372165,4.0,4.0,20.0
5472904,1524208537,1524208548,11,218,7.429117916875697,4.0,4.0,22.0
5472905,1524208541,1524208590,49,218,8.97046015054662,4.0,1.0,40.2663566347921
5472906,1524208589,1524208599,10,206,14.238381984517156,5.0,4.1,50.0
5472907,1524208596,1524208603,7,112,24.28835577971202,15.063985748115321,5.0,55.0
5472908,1524208600,1524208648,48,205,4.16264914351713,4.0,4.0,4.0
5472909,1524208649,1524208667,18,210,29.10775507980008,22.0,5.0,62.07878401453224
5472910,1524208664,1524208688,24,160,9.589827217442291,5.0,4.0,20.0
5472911,1524208688,1524208701,13,159,13.905321538332359,5.0,4.0,50.0
5472912,1524208701,1524208725,24,258,11.130239257177625,5.0,1.0,50.0
5472913,1524208722,1524208737,15,179,11.854759265064226,5.0,4.0,30.0
5472914,1524208737,1524208743,6,166,12.711000276169678,4.000000000358918,4.0,43.42131058190639
5472915,1524208743,1524208756,13,208,8.77812024461536,5.0,4.0,30.0
5472916,1524208757,1524208771,14,197,8.59936661422569,4.0000000005572645,4.0,30.0
5472917,1524208765,1524208778,13,213,12.498353906147816,5.0,4.0,39.84843102564102
5472918,1524208775,1524208789,14,36,33.47302190638717,30.0,0.0,85.02898190045238
5472919,1524208793,1524208806,13,227,19.163956311098254,8.000000000821377,4.0,63.902317249999996
5472920,1524208797,1524208815,18,258,19.860221175607037,5.0,4.1,54.514671252924806
5472922,1524208807,1524208816,9,342,6.633916352143828,4.1,4.1,13.749105504002157
5472923,1524208811,1524208832,21,236,9.466008342277437,4.0,4.0,20.792072251793567
5472924,1524208831,1524208847,16,135,19.46840051055568,8.10622390073136,5.0,55.0
5472925,1524208847,1524208851,4,215,9.132998059817863,4.000000001,4.0,21.0
5472926,1524208851,1524208882,31,219,7.054854562544103,4.0,4.0,21.39669372693726
5472927,1524208882,1524208894,12,200,39.7450630212318,30.0,5.0,100.0
5472928,1524208890,1524208906,16,210,20.300699014505607,5.0,4.0,80.4413116108941
5472929,1524208905,1524208940,35,212,8.911243244413548,4.1,4.0,36.65130117647056
5472930,1524208938,1524208945,7,181,10.757043390342046,5.0,4.0,39.38512896551722
5472931,1524208942,1524208949,7,129,21.82589443981998,5.0,1.0,55.0
5472932,1524208946,1524208960,14,330,4.204283656829934,4.1,4.0,4.1
5472933,1524208958,1524208963,5,190,7.001961765951591,4.0,4.0,22.69651302976908
5472934,1524208962,1524208979,17,204,11.430675942739871,5.0,4.0,30.0
5472935,1524208976,1524209002,26,192,10.748182180494474,4.1,4.0,40.651271379310344
5472936,1524209002,1524209012,10,229,13.578571973155483,5.437144258789436,1.0,50.18493629807692
5472937,1524209011,1524209048,37,138,11.953445761095763,8.2,4.1,30.0
5472938,1524209047,1524209085,38,123,6.0971152867464475,4.81,4.0,5.384216301351882
5472939,1524209084,1524209094,10,135,28.298350691177887,21.0,5.0,55.1
5472940,1524209093,1524209107,14,152,8.800985154028258,5.0,4.0,20.76251615366813
5472941,1524209105,1524209112,7,163,11.541757750474082,5.0,4.1,55.0
5472942,1524209111,1524209134,23,196,6.445921571239048,4.0,4.0,8.74895017319509
5472943,1524209132,1524209166,34,211,11.171864556936638,5.563682130949764,4.0,30.0
5472944,1524209166,1524209178,12,87,38.43583171278181,50.0,0.0,65.28269779397479
5472945,1524209178,1524209191,13,218,5.3905177327539935,4.1,4.1,8.625167924017054
5472946,1524209189,1524209198,9,176,8.622916888145136,5.0,4.0,27.13047422222222
5472947,1524209198,1524209210,12,322,5.912871821413745,4.1,4.1,9.96885883038074
5472948,1524209209,1524209228,19,198,6.559965645353641,4.0,4.0,19.401211432225505
5472949,1524209227,1524209237,10,247,13.782880149865612,5.0,1.0,55.0
5472950,1524209235,1524209242,7,339,5.758052251677277,4.1,4.1,8.519357017334308
5472951,1524209241,1524209263,22,31,21.81768954049158,8.35919407704276,1.0,71.75123230165649
5472952,1524209263,1524209280,17,272,9.484082946972011,4.1,4.1,24.002272516129032
5472953,1524209279,1524209294,15,204,6.408661414510325,4.0,4.0,20.529078228782282
5472954,1524209292,1524209311,19,169,30.27049380362958,14.139758593749985,5.0,91.0
5472955,1524209310,1524209337,27,348,8.617970871212579,4.1,4.1,20.683567584978583
5472956,1524209336,1524209394,58,136,9.882469474994,5.0,4.0,50.0
5472957,1524209393,1524209425,32,186,15.403105895852677,8.2,4.1,50.0
5472958,1524209424,1524209444,20,233,15.959409733717788,5.0,1.0,55.67930687660765
5472959,1524209443,1524209466,23,84,54.1667147660759,55.0,22.662834317343172,91.0
5472960,1524209466,1524209471,5,49,22.181137942682565,20.0,2.319735101160327,60.0
5472961,1524209470,1524209478,8,256,6.248588828452481,5.0,5.0,8.581402335526741
5472962,1524209474,1524209497,23,8,43.4358252987325,55.0,21.0,55.0
5472963,1524209496,1524209514,18,189,18.773442170257297,5.0,4.1,54.305010368332695
5472964,1524209513,1524209520,7,226,5.708196292047109,4.0,4.0,12.0
5472965,1524209518,1524209526,8,132,6.5161589780670415,4.1,4.000000001,11.396618901693204
5472966,1524209520,1524209536,16,172,9.209083767856875,4.0,4.0,50.0
5472967,1524209535,1524209555,20,191,9.099552189963863,6.107975297619047,4.0,40.01560844444443
5472968,1524209554,1524209567,13,191,14.447173516511848,4.1,4.0,64.45061900097943
5472969,1524209566,1524209573,7,210,8.929363205325034,4.0,4.0,41.0
5472970,1524209571,1524209595,24,217,6.65604884343264,4.00000000026815,4.0,19.27487159855965
5472971,1524209595,1524209607,12,177,14.675791805793033,5.546755714460004,4.0,51.13249790861752
5472972,1524209603,1524209616,13,214,6.586869914731351,4.0,4.0,13.53387253505534
5472973,1524209615,1524209632,17,200,10.628520514581274,4.1,4.0,51.20325223367694
5472974,1524209632,1524209657,25,208,19.39637579786994,4.1,4.1,53.47561076193502
5472975,1524209655,1524209660,5,180,12.841554195358134,5.0,4.0,40.29099780864
5472976,1524209660,1524209665,5,161,7.82861085338389,4.0,4.0,26.458966071428527
5472977,1524209664,1524209705,41,186,6.993584608874789,4.0,1.0,13.651800527578006
5472978,1524209705,1524209724,19,171,20.423038973420393,6.46875,4.1,60.0
5472979,1524209723,1524209730,7,204,12.275589350992137,5.0,4.0,50.0
5472980,1524209730,1524209790,60,356,5.851307298548452,4.1,4.1,20.0
5472981,1524209789,1524209803,14,207,17.727429053415708,15.010845541480279,4.1,50.0
5472982,1524209802,1524209818,16,220,13.223154964169057,4.1,4.0,43.126252410111505
5472983,1524209815,1524209829,14,294,15.043590161301617,4.1,4.1,55.0
5472984,1524209829,1524209864,35,176,10.001805985279454,7.5969786716801515,4.0,27.459211536820423
5472985,1524209865,1524209886,21,243,13.818371253233154,7.064982588923973,1.0,50.0
5472986,1524209884,1524209921,37,286,13.355135454478564,5.0,4.1,50.0
5472987,1524209921,1524209931,10,176,18.611129853849416,8.674792270045348,4.1,51.073294503656484
5472988,1524209929,1524209996,67,197,8.67797356492153,4.00000000025307,4.0,29.45669279279272
5472989,1524209995,1524210004,9,122,29.09303743048593,21.207927372654837,11.866772711064279,53.46008231316392
5472990,1524210002,1524210011,9,107,10.176548579077282,6.0,4.79615760319491,27.88599699143716
5472991,1524210013,1524210039,26,108,10.995081509419379,4.170451458333334,4.1,51.9
5472992,1524210038,1524210071,33,221,31.020452118937246,6.0,4.0,50.0
5472993,1524210069,1524210077,8,80,24.12566290479208,22.0,3.829349074835794,55.000000000658225
5472994,1524210071,1524210079,8,35,5.339806919689315,2.0,1.0,27.72915669924434
5472995,1524210079,1524210105,26,217,9.209940534628773,5.0,4.0,50.0
5472996,1524210105,1524210114,9,224,12.297169717082648,4.8,1.0,50.0
5472997,1524210115,1524210138,23,82,30.408304990008595,20.0,0.0,55.1
5472998,1524210138,1524210169,31,231,11.763424720308569,5.0,4.1,50.0
5472999,1524210167,1524210179,12,146,16.167529420180365,5.098571729957806,4.0,55.64020664560549
5473000,1524210177,1524210204,27,214,6.296310113491514,4.000000000698268,4.0,11.941858058787485
5473001,1524210206,1524210252,46,217,13.05879064324324,6.6771075854088195,1.0,51.9
5473002,1524210252,1524210265,13,152,15.745288245616136,8.16345501220703,4.664333899479867,50.0
5473003,1524210265,1524210274,9,192,16.963051549709444,6.0,4.1,55.1812361391612
5473004,1524210274,1524210280,6,211,10.263865364559278,4.1,4.0,20.857633323847466
5473005,1524210280,1524210295,15,16,69.71745562130178,50.0,30.220689655172414,112.1
5473006,1524210289,1524210301,12,207,10.992618027345754,5.0,4.0,22.06332408345751
5473007,1524210301,1524210320,19,202,8.175148689530925,4.0,4.0,38.908941090766604
5473008,1524210317,1524210326,9,122,10.61238900975059,5.0,4.0,50.0
5473009,1524210323,1524210339,16,202,10.625982538451234,5.0,4.0,20.97987246175691
5473010,1524210339,1524210363,24,170,8.99668553049704,4.1,4.0,47.557609822548116
5473011,1524210362,1524210382,20,205,42.40441047508398,5.0,4.0,55.0
5473012,1524210380,1524210391,11,213,13.247007143405138,5.9410120346966915,4.0,46.605607356230564
5473013,1524210391,1524210407,16,215,13.23977555923254,4.1,4.0,55.0
5473014,1524210405,1524210437,32,186,6.989542248425696,5.0,4.0,24.88676411764704
5473015,1524210437,1524210478,41,129,52.689281549058975,55.1,24.1,55.595036257232
5473016,1524210478,1524210483,5,189,16.652195198508295,9.842374228432671,4.549342485380117,50.561657478780695
5473017,1524210483,1524210489,6,184,7.596201355642498,4.1,4.0,35.46919411764702
5473018,1524210488,1524210523,35,91,35.705042592198325,24.1,20.0,98.53532799999992
5473019,1524210524,1524210549,25,170,5.899412505226544,5.0,4.0,9.417055003722256
5473020,1524210548,1524210577,29,181,15.082382603475601,5.0,4.0,56.084444765362484
5473021,1524210577,1524210586,9,193,15.456942100759841,7.450792941800809,4.0,50.0
5473022,1524210585,1524210606,21,204,28.947968075855975,10.0,10.0,64.13547445887444
5473023,1524210606,1524210614,8,175,10.442197493171195,6.324611381880734,4.0,24.338365794863037
5473024,1524210613,1524210622,9,225,7.459839738385901,4.0,1.0,40.98351395638317
5473025,1524210619,1524210638,19,267,4.1082078834913744,4.0,1.0,5.884722318222213
5473026,1524210638,1524210643,5,232,12.419838577657746,5.0,4.0,41.0
5473028,1524210657,1524210667,10,224,8.50481619146495,4.1,4.0,30.61908676251841
5473029,1524210664,1524210676,12,192,8.50789605850205,4.0,4.0,50.0
5473030,1524210667,1524210682,15,177,39.393755699261106,7.487063813033453,4.0,99.0
5473031,1524210676,1524210687,11,217,10.96463617244265,5.0,4.0,28.26188010072657
5473032,1524210684,1524210702,18,204,11.406081378612718,4.0,4.0,35.57770158564246
5473033,1524210700,1524210722,22,210,20.117483347760487,10.0,10.0,50.0
5473034,1524210720,1524210726,6,222,11.01750061339003,5.0,4.0,41.0
5473035,1524210725,1524210739,14,184,9.384209717001442,5.415390755208334,4.0,45.05799579158811
5473036,1524210738,1524210750,12,247,12.393140898841887,5.576486714285716,4.1,54.200964244761686
5473037,1524210748,1524210761,13,214,11.205736740775434,4.097039808642042,4.0,50.0
5473038,1524210762,1524210789,27,83,13.144394233807636,8.018837455487644,4.0,32.3210953099924
5473039,1524210787,1524210793,6,193,12.303913752371786,4.1,4.0,51.41706716455911
5473040,1524210795,1524210800,5,207,14.156942408576592,4.1,4.0,60.0
5473041,1524210798,1524210808,10,214,11.067908137145162,5.0,4.0,19.813682129764988
5473042,1524210802,1524210818,16,16,27.04277488361236,11.80367550660036,0.0,94.83708952154947
5473043,1524210807,1524210821,14,191,6.535764656816767,4.0,4.0,17.015107812499917
5473044,1524210813,1524210836,23,341,7.093202325050545,4.1,4.1,20.79785345786499
5473045,1524210835,1524210845,10,116,11.01380991291719,5.44922940357158,4.0,36.3873456559146
5473046,1524210843,1524210849,6,12,4.04336966402291,4.0,4.0,4.0
5473047,1524210848,1524210861,13,179,9.195105115381976,4.1,4.0,41.0
5473048,1524210860,1524210881,21,169,9.857627823440016,5.132012568780226,4.0,41.0
5473049,1524210880,1524210886,6,254,10.425198290364174,5.0,1.0,41.0
5473050,1524210886,1524210894,8,49,49.076018694957945,50.0,20.75991140303979,110.24563531034482
5473051,1524210892,1524210907,15,29,43.7267016181061,41.0,15.5,99.0
5473052,1524210905,1524210925,20,224,4.701965692097821,4.1,4.0,8.157563625730988
5473053,1524210924,1524210954,30,207,15.046348244425957,5.92429684,4.0,50.0
5473054,1524210953,1524210964,11,171,22.113819053083876,7.1,4.0,53.81784703315736
5473055,1524210963,1524210975,12,82,55.41889355979464,50.0,40.0,91.44938506787328
5473056,1524210975,1524210983,8,166,8.61893470235865,5.0,4.0,34.29414802411055
5473057,1524210983,1524210992,9,21,28.75181746750695,20.466373371850437,16.995431622182682,67.14615079999984
5473058,1524210993,1524211003,10,221,7.1651338912131095,4.1,1.0,20.901559649460314
5473059,1524211002,1524211061,59,186,24.208307566047417,10.0,4.0,54.61243118772686
5473060,1524211062,1524211074,12,286,18.832761017167357,8.0,1.0,60.213068756121444
5473061,1524211072,1524211076,4,182,22.007391576272113,10.0,4.0,54.800349924454665
5473062,1524211076,1524211090,14,217,12.938806497879257,4.1,4.0,50.52877263091391
5473063,1524211089,1524211099,10,208,10.81258243050438,5.0,1.2397921428571461,50.0
5473064,1524211098,1524211162,64,179,6.192437627381756,4.0,4.0,13.475595743488821
5473065,1524211162,1524211186,24,209,35.7536149145786,30.0,5.77227182038835,91.0
5473066,1524211184,1524211189,5,89,21.21122976532513,8.256008579101561,5.0,82.23512134250275
5473067,1524211187,1524211192,5,170,6.264197764034839,4.1,4.1,11.378383697516975
5473068,1524211191,1524211223,32,218,6.461029524637821,4.0,1.0,13.50574444606383
5473069,1524211222,1524211239,17,249,17.03508919979729,8.2,5.0,52.41754691369782
5473070,1524211236,1524211255,19,274,11.004853600160743,5.0,4.1,42.14770764033897
5473071,1524211248,1524211271,23,218,13.064423715550726,4.000000001,4.0,46.693753395059055
5473072,1524211272,1524211288,16,47,42.1586788804426,50.79030848551979,20.0,54.96143343053661
5473073,1524211281,1524211305,24,253,10.724048663919328,6.0,1.0,34.86754403876905
5473074,1524211305,1524211311,6,204,15.220682435404253,5.0,4.0,51.89392651014308
5473075,1524211309,1524211355,46,224,12.440765944867778,4.0,4.0,55.1
5473076,1524211355,1524211360,5,187,17.174627005514676,7.175782999999997,4.0,50.71216134775934
5473077,1524211358,1524211369,11,123,5.201408800104014,4.0,4.0,5.711093597546864
5473078,1524211367,1524211383,16,329,11.766653567454908,4.1,4.1,55.0
5473079,1524211383,1524211398,15,217,9.320984943814214,4.1,4.0,50.0
5473080,1524211398,1524211441,43,37,32.41411889133315,48.824190069069246,0.0,59.39444523383988
5473081,1524211439,1524211458,19,103,39.290170632948495,50.0,15.5,67.26376770404049
5473082,1524211451,1524211480,29,83,35.06687311551863,25.407422163626617,12.541939274666667,81.70999140495867
5473083,1524211479,1524211486,7,180,20.192839744651206,8.0,4.1,85.07034562387304
5473084,1524211485,1524211493,8,221,4.618099693791593,4.1,1.0,6.149464545454538
5473085,1524211492,1524211509,17,21,28.875967615639492,24.89918801306618,1.0,55.1
5473086,1524211509,1524211519,10,239,7.303468537948291,5.0,1.0,20.027854613536817
5473087,1524211517,1524211545,28,198,10.166461343911777,4.1,4.0,20.0
5473088,1524211543,1524211561,18,209,11.164174347046625,4.1,4.0,41.0
5473089,1524211558,1524211579,21,247,7.409484781824874,4.0,4.0,20.0
5473090,1524211569,1524211583,14,252,7.329922810180427,4.1,4.0,24.1
5473091,1524211576,1524211593,17,282,13.106414289437483,7.1,7.1,55.0
5473092,1524211591,1524211611,20,193,13.817361625122462,5.0,4.0,57.0346872402103
5473093,1524211610,1524211621,11,184,11.412786035718165,4.1,4.0,50.0
5473094,1524211617,1524211632,15,318,5.214813379589067,4.0,4.0,11.471703930338501
5473095,1524211626,1524211638,12,240,7.407906183023015,4.0,3.2,24.1
5473096,1524211635,1524211646,11,223,9.069607983134665,4.1,4.0,22.982030464203234
5473097,1524211644,1524211656,12,109,13.140371647338977,8.0,3.2,50.0
5473098,1524211652,1524211682,30,322,7.481241899978403,4.1,4.0,13.794991418224987
5473099,1524211678,1524211703,25,162,14.159140583621557,5.0,4.0,50.0
5473100,1524211703,1524211715,12,204,11.961510217811986,5.0,4.0,44.7594818983441
5473101,1524211712,1524211724,12,307,10.66987505914591,4.0,1.0,55.034817854948265
5473102,1524211721,1524211729,8,261,9.298382221092227,4.0,3.2,41.0
5473103,1524211725,1524211749,24,308,8.817269607045755,4.0,4.0,56.9183109696376
5473104,1524211748,1524211802,54,221,9.787390128167264,4.443773239266133,4.0,44.1658748463013
5473105,1524211799,1524211821,22,143,22.570347085282343,8.867863984932786,5.0,55.1
5473106,1524211820,1524211828,8,85,8.953017664787586,5.0,4.358862384348617,38.21635689655172
5473107,1524211828,1524211843,15,241,7.159768924054232,4.0,1.0,20.682260472112937
5473108,1524211842,1524211852,10,271,6.772765768937789,4.1,4.0,11.891737683458935
5473109,1524211852,1524211867,15,212,7.1629617464400095,3.2,1.0,51.9481462140992
5473110,1524211861,1524211870,9,113,8.16242200029962,4.0,3.0,32.623249174707844
5473111,1524211868,1524211875,7,246,7.288157572889474,4.1,4.0,50.0
5473112,1524211875,1524211888,13,317,13.200361686845781,4.1,4.1,50.0
5473113,1524211886,1524211901,15,320,10.822587951597294,4.1,4.1,50.0
5473114,1524211902,1524211923,21,230,8.2396349044334,4.0,4.0,20.84151354121306
5473115,1524211923,1524211956,33,234,8.926878943754573,4.1,4.0,50.0
5473116,1524211956,1524211961,5,215,18.51013339783269,5.187532839506174,4.0,60.0
