block_number,block_timestamp,my_timestamp,timestamp_delta,tx_count,avg_gas_price,median_gas_price,q5_gas_price,q95_gas_price
5570487,1525672787,1525672830,43,170,12.503875133245609,4.0,2.0,50.0
5570488,1525672814,1525672839,25,153,13.760231438181025,6.07113248,2.2,50.0
5570489,1525672839,1525672852,13,203,14.844912974759993,5.0,2.0,52.05268560235059
5570490,1525672852,1525672868,16,248,11.1593057461113,4.9,1.0,50.0
5570491,1525672860,1525672869,9,134,4.420306824662779,2.0,1.0,15.501932085129306
5570492,1525672866,1525672896,30,149,6.527147852539311,1.0,1.0,14.115698919981646
5570493,1525672891,1525672905,14,128,10.791219310294794,6.0,1.9897488981842892,40.58798234833484
5570494,1525672904,1525672929,25,318,4.217828027101979,1.0,1.0,20.00000000008002
5570495,1525672932,1525672961,29,146,10.077321948880764,6.0,2.0,28.089617117116926
5570496,1525672959,1525672969,10,173,11.77017649874804,5.0,3.0,55.054239046746105
5570497,1525672967,1525672986,19,106,5.791838998960842,2.2,2.0,14.929772515188336
5570498,1525672985,1525673023,38,179,5.563745615293257,2.034387900388958,1.0,23.50996742081446
5570499,1525673023,1525673032,9,329,11.80742498341644,4.9,4.9,50.0
5570500,1525673030,1525673048,18,357,5.722457737558581,4.9,4.9,10.0
5570501,1525673037,1525673083,46,118,7.873247038337051,4.047904776124229,2.0,50.0
5570502,1525673082,1525673101,19,149,13.269516463794444,10.0,3.0,50.0
5570503,1525673100,1525673110,10,124,12.923906494527559,5.982373294320726,2.0,50.0
5570504,1525673108,1525673120,12,275,2.934734121940392,1.0,1.0,12.185870064724917
5570505,1525673121,1525673139,18,81,29.549262059501075,28.0,12.0,51.9
5570506,1525673139,1525673152,13,160,6.034908249137453,4.0,2.0,18.697946633984706
5570507,1525673151,1525673171,20,251,6.10135704779195,1.1,1.0,20.0
5570508,1525673167,1525673183,16,186,6.702251900074953,2.0,1.0,17.66560147058814
5570509,1525673183,1525673218,35,254,7.224847369123034,5.0,4.9,27.718771145833195
5570510,1525673194,1525673257,63,259,3.429502841680102,2.0,1.0,3.2891120606060604
5570511,1525673210,1525673257,47,170,6.583717149795412,1.0000828886627062,1.0,50.0
5570512,1525673217,1525673258,41,255,5.230028742749355,2.078310143646409,1.0,12.59520379695197
5570513,1525673220,1525673259,39,297,4.519877023204762,2.0,1.0,19.56321887876738
5570514,1525673248,1525673271,23,238,11.92715816245377,6.0,2.0,45.59926698576589
5570515,1525673269,1525673288,19,333,10.88998605756522,4.9,4.9,50.0
5570516,1525673272,1525673290,18,182,3.0553093223870302,2.0,2.0,4.870125029411753
5570517,1525673280,1525673306,26,294,1.415441604864572,1.1,1.0,1.5
5570518,1525673303,1525673322,19,317,9.849179820954525,5.836127508600917,4.9,44.83481263528112
5570519,1525673319,1525673363,44,302,9.81106826021024,4.9,4.9,50.0
5570520,1525673344,1525673382,38,313,8.470222973902853,4.9,4.9,28.0
5570521,1525673365,1525673383,18,275,5.475094363992904,3.0,1.0,21.03169106556052
5570522,1525673371,1525673384,13,292,3.707533275102985,2.0,2.0,6.0
5570523,1525673382,1525673453,71,253,7.934848071460938,2.5014916060479706,1.0,25.207424615384536
5570524,1525673440,1525673478,38,95,35.38461107456853,28.0,21.0,59.025145754330836
5570525,1525673474,1525673489,15,185,15.903622851135019,12.0,6.0,50.0
5570526,1525673485,1525673504,19,15,44.44113960972226,41.98847157863183,20.0,100.08165405405406
5570527,1525673491,1525673539,48,9,28.60714648622484,20.0,18.007638656,54.10615344382984
5570528,1525673527,1525673540,13,140,15.785573466024195,11.961185668103449,5.0,50.0
5570529,1525673534,1525673552,18,192,5.3655047249095675,4.0,2.0,10.649607666666665
5570530,1525673551,1525673572,21,243,8.094626666794484,5.0,1.0,28.0
5570531,1525673559,1525673590,31,313,3.282763332020335,2.0,2.0,4.0
5570532,1525673587,1525673591,4,183,9.316651481335036,5.309123578357057,2.1436234415506985,25.0
5570533,1525673593,1525673615,22,273,3.560348250482998,2.0,2.0,5.424265429234335
5570534,1525673616,1525673640,24,273,9.643770911245324,5.773524417945991,2.0,44.13089908952942
5570535,1525673640,1525673655,15,234,16.392835403865025,5.368930258426967,4.9,50.0
5570536,1525673653,1525673676,23,370,6.777630982013375,4.9,4.9,12.025964774826448
5570537,1525673675,1525673684,9,206,12.013140461592391,6.0,4.0,50.0
5570538,1525673685,1525673712,27,233,4.388950115282194,2.1569638351805867,1.0,6.0
5570539,1525673709,1525673727,18,265,8.7638871715852,4.0,1.0,41.0
5570540,1525673714,1525673731,17,121,7.1875652336124265,4.9,2.2,21.34532857142844
5570541,1525673725,1525673747,22,315,2.9630988204300692,2.0,2.0,4.0
5570542,1525673734,1525673749,15,270,12.053229944910717,5.712357142857142,2.0,50.0
5570543,1525673749,1525673761,12,349,7.4387559369729885,4.9,4.9,28.0
5570544,1525673763,1525673772,9,268,5.961012153390837,2.0,1.0,19.552925668979174
5570545,1525673774,1525673786,12,21,7.461027046370111,7.4105939271765155,2.0,8.0
5570546,1525673785,1525673804,19,233,9.438591175095995,4.0,2.0,50.0
5570547,1525673800,1525673822,22,284,5.247000521094077,2.0,2.0,24.828140889423075
5570548,1525673822,1525673847,25,314,10.406236538000014,4.9,4.9,50.0
5570549,1525673845,1525673857,12,306,10.451519109514578,4.9,4.9,50.0
5570550,1525673856,1525673867,11,213,6.780503579689299,4.0,2.0,14.73394629404617
5570551,1525673865,1525673885,20,349,5.120863928925836,4.9,4.9,5.0
5570552,1525673878,1525673900,22,224,6.341890674030231,4.0,2.0,31.648334999999992
5570553,1525673898,1525673945,47,147,13.291702183080831,5.956922365256699,4.9,50.0
5570554,1525673943,1525673964,21,207,13.73639054111273,5.210954189893359,4.9,50.0
5570555,1525673963,1525673975,12,210,6.171914952055828,4.0,2.0,17.78457110837438
5570556,1525673973,1525673995,22,219,9.747450254563734,3.0,2.0,50.0
5570557,1525673977,1525673999,22,283,5.199063628419137,2.0,2.0,11.49297478252352
5570558,1525673998,1525674009,11,252,10.8381727581376,3.0,2.0,50.0
5570559,1525674006,1525674035,29,76,42.4747024107161,50.0,9.371735841584158,50.0
5570560,1525674016,1525674045,29,277,4.211867910246337,2.0,2.0,6.179481856148492
5570561,1525674035,1525674065,30,151,14.031787997494654,6.0,2.0,50.0
5570562,1525674048,1525674066,18,264,11.303683410536525,4.0,2.0,50.0
5570563,1525674052,1525674068,16,45,58.68886340111494,50.0,50.0,112.0
5570564,1525674068,1525674103,35,62,12.008165191326537,12.0,2.0637774390243906,35.82158908794781
5570565,1525674073,1525674105,32,252,6.244209300937202,2.0,2.0,42.4682926596481
5570566,1525674081,1525674105,24,293,6.263914650972164,2.0,2.0,41.0
5570567,1525674092,1525674106,14,288,8.074969728154821,2.0,2.0,50.0
5570568,1525674097,1525674119,22,282,3.0755961821767785,2.0,2.0,5.902090157894729
5570569,1525674108,1525674119,11,44,39.8334282067182,42.17181081658925,20.0,51.86973153846154
5570570,1525674111,1525674128,17,214,7.432249212748594,5.0,2.0,13.105751824919123
5570571,1525674116,1525674129,13,373,6.141365180575861,4.9,4.9,6.0
5570572,1525674122,1525674138,16,351,5.745300747201886,4.9,4.9,6.317587299999998
5570573,1525674131,1525674153,22,184,6.71612787323488,4.0,4.0,15.0
5570574,1525674141,1525674163,22,237,6.678923574103094,3.0,2.0,13.94825063106796
5570575,1525674159,1525674172,13,230,7.371266918268731,3.3272857142857126,1.0,36.76741246705739
5570576,1525674162,1525674188,26,285,2.673513490535906,2.0,2.0,2.0
5570577,1525674181,1525674205,24,168,6.606254867163798,4.0,4.0,21.218304687499952
5570578,1525674189,1525674220,31,118,27.665353107077653,15.0,4.9,50.0
5570579,1525674205,1525674248,43,211,7.661940635681162,2.1094022068965517,1.0,44.79774095940957
5570580,1525674247,1525674264,17,178,17.888781982684584,10.0,4.0,60.0
5570581,1525674252,1525674265,13,164,11.567489554066901,4.0,2.0948703510108677,50.0
5570582,1525674256,1525674281,25,34,10.043694809587434,2.8089129439229157,2.0,50.0
5570583,1525674266,1525674297,31,348,10.025935777452029,4.9,4.9,50.0
5570584,1525674292,1525674307,15,143,46.49569357025515,50.0,20.0,74.05525504587152
5570585,1525674302,1525674327,25,267,7.155401475345138,4.9,4.9,14.817838562499986
5570586,1525674317,1525674336,19,241,9.006353095705029,4.0,3.0,50.0
5570587,1525674323,1525674349,26,265,4.223045183895454,2.0,2.0,17.085539726027374
5570588,1525674336,1525674360,24,245,4.914532405570994,2.0,2.0,11.692534999999934
5570589,1525674343,1525674361,18,264,8.050139542775733,4.0,2.0,27.507052246955688
5570590,1525674352,1525674370,18,266,6.211920690950482,4.9,4.0,14.136231688524262
5570591,1525674360,1525674443,83,295,7.126623833448742,5.0,1.0,20.152227664399092
5570592,1525674442,1525674460,18,244,21.01188378016054,20.0,5.6142462370327975,50.0
5570593,1525674448,1525674461,13,157,8.4125014910472,5.0,3.0,32.36449111111099
5570594,1525674452,1525674491,39,249,5.601268842801685,2.0,2.0,30.151293529411753
5570595,1525674490,1525674501,11,215,26.758645313973016,20.0,5.0,50.88434359999998
5570596,1525674496,1525674531,35,360,5.963963345944344,4.9,4.9,12.460093734163419
5570597,1525674502,1525674532,30,126,13.349078989441834,4.9,4.9,50.0
5570598,1525674510,1525674542,32,77,5.851569983951525,4.0,2.3086490196078437,16.154216438356144
5570599,1525674526,1525674554,28,318,11.410537317200067,4.9,4.9,50.0
5570600,1525674555,1525674581,26,11,50.92683663398963,50.0,50.0,60.22451450688544
5570601,1525674580,1525674597,17,128,33.03677066905261,28.0,9.3358869323262,91.0
5570602,1525674587,1525674599,12,244,6.606624730364383,4.196298482758619,1.0,14.580154337788578
5570603,1525674591,1525674608,17,367,6.513834648916595,4.9,4.9,10.0
5570604,1525674602,1525674609,7,144,9.569871952167146,4.9,4.0,47.06666925780289
5570605,1525674605,1525674629,24,203,2.017201767668344,2.0453120399274267,1.0,3.6375637243838823
5570606,1525674612,1525674687,75,284,6.389363415894378,2.0883283489572992,2.0,14.863951713244226
5570607,1525674684,1525674717,33,99,28.90508635483458,14.946613038288573,4.0,51.424001685714266
5570608,1525674690,1525674737,47,232,9.851384030115556,5.0,3.0,44.95132147435385
5570609,1525674721,1525674750,29,309,16.635825505619234,5.0,4.9,50.0
5570610,1525674741,1525674766,25,334,10.76522334587605,4.9,4.9,50.0
5570611,1525674762,1525674775,13,199,14.196523729568776,5.0,4.0,54.0
5570612,1525674775,1525674806,31,231,8.752992743177357,4.0,2.0002,36.36344882594405
5570613,1525674804,1525674828,24,224,18.914076783091954,10.0,4.9,55.99583987617923
5570614,1525674808,1525674857,49,106,14.540662173316663,10.476176993534482,5.207736969580838,41.0
5570615,1525674855,1525674902,47,19,37.710749146931626,41.0,20.0,52.34462288388844
5570616,1525674900,1525674923,23,183,16.5251946504967,11.976755241935484,5.0,53.09717896668314
5570617,1525674908,1525674944,36,228,8.005923977227052,5.0,2.0,50.0
5570618,1525674943,1525674973,30,150,13.655578578930479,6.0,4.498905983350677,50.0
5570619,1525674973,1525675004,31,306,18.125369108691054,4.9,4.9,60.0
5570620,1525674986,1525675005,19,235,4.235028467592238,1.0,1.0,14.263274999999961
5570621,1525675001,1525675029,28,246,12.795520993204477,5.685511815178882,1.0,50.0
5570622,1525675012,1525675031,19,165,6.895840113231514,4.0,4.0,19.12287029132186
5570623,1525675024,1525675058,34,326,8.738966819930692,4.9,4.9,31.44665564516128
5570624,1525675038,1525675067,29,213,4.136399509985223,4.0,1.0,4.0
5570625,1525675066,1525675108,42,165,17.120944716169678,11.964935391009853,4.9,57.755351604032974
5570626,1525675103,1525675132,29,180,9.189027872067218,5.0,4.9,21.0
5570627,1525675116,1525675154,38,274,7.259607149015701,4.9,4.9,16.0
5570628,1525675123,1525675157,34,16,28.62172419319127,20.0,20.0,50.0
5570629,1525675128,1525675158,30,342,7.337873219410383,4.9,4.9,14.30484366084163
5570630,1525675140,1525675159,19,108,6.718724150114515,4.0,4.0,8.84260415704387
5570631,1525675150,1525675170,20,83,13.486005495743933,4.0,3.0,44.55178425833037
5570632,1525675159,1525675183,24,266,5.881486453811238,3.0,2.0,12.0
5570633,1525675173,1525675202,29,169,10.655429479937023,5.0,2.0,54.82322916666665
5570634,1525675200,1525675214,14,215,24.53595131784505,5.696349463559976,2.0,60.0
5570635,1525675210,1525675238,28,307,15.642961073862644,4.9,4.9,50.0
5570636,1525675216,1525675240,24,212,6.124109421186667,4.0,2.0,22.54943176470569
5570637,1525675238,1525675256,18,310,11.678661137889856,4.9,4.9,50.0
5570638,1525675247,1525675290,43,162,5.669221390412566,4.0,4.0,17.040423913043377
5570639,1525675288,1525675357,69,243,17.34253840947094,12.291861537869458,4.9,50.0
5570640,1525675339,1525675358,19,250,17.979116582231054,2.0,2.0,57.19861025955439
5570641,1525675346,1525675359,13,259,6.588204138410863,5.0,5.0,20.0
5570642,1525675350,1525675359,9,209,7.465541395641861,4.0,2.0,30.42779326923077
5570643,1525675354,1525675410,56,173,8.28953495950931,5.0,4.0,20.0
5570644,1525675376,1525675454,78,196,7.041693073114762,4.0,1.0,41.0
5570645,1525675383,1525675454,71,167,7.664452910573014,4.0,4.0,25.203244706231942
5570646,1525675407,1525675455,48,238,17.72208361945777,7.360696428571429,4.9,51.9
5570647,1525675428,1525675482,54,138,19.18252303318257,5.6875,4.9,85.58738016528847
5570648,1525675444,1525675482,38,166,12.91846956209415,4.0,4.0,50.0
5570649,1525675450,1525675482,32,254,8.798986941980427,5.0,1.0,22.87424062142645
5570650,1525675456,1525675483,27,202,8.509491793570499,3.0,2.0,45.08321129689448
5570651,1525675462,1525675483,21,340,7.600964053810648,4.9,4.9,19.89372382161455
5570652,1525675482,1525675530,48,195,9.022375797143438,4.0,2.0,48.741493805438694
5570653,1525675528,1525675554,26,240,13.84963900509391,5.0,2.0,50.0
5570654,1525675557,1525675583,26,206,11.308230211452424,5.0,1.0,50.0
5570655,1525675581,1525675649,68,209,16.608684852591377,9.838540408147916,4.0,50.0
5570656,1525675627,1525675654,27,211,22.315413735270774,10.0,5.0,51.9
5570657,1525675643,1525675684,41,193,5.834510966768947,3.0,2.0,21.962338437499994
5570658,1525675689,1525675716,27,159,14.497891755152768,10.0,4.0,50.0
5570659,1525675701,1525675719,18,180,8.707658848746338,4.0,4.0,40.0
5570660,1525675707,1525675748,41,243,6.503391285425622,2.0,2.0,24.51395764705881
5570661,1525675744,1525675776,32,308,15.651199911558862,8.738435481167324,4.9,50.0
5570662,1525675762,1525675803,41,187,9.249352852737502,4.9,3.0,50.0
5570663,1525675769,1525675807,38,235,5.643090466166824,2.4783457728697873,2.0,27.948805315315237
5570664,1525675787,1525675807,20,166,12.788219353094277,5.0,4.9,33.83140212499998
5570665,1525675801,1525675837,36,296,16.326837235741824,4.9,4.9,53.85474356846474
5570666,1525675828,1525675862,34,124,18.288496589093352,5.0,3.0,50.0
5570667,1525675851,1525675876,25,283,9.302490903242694,2.0,1.0,41.0
5570668,1525675859,1525675890,31,115,15.992793467269749,15.0,9.861905591310382,28.0
5570669,1525675868,1525675891,23,259,4.795531776629198,2.0,2.0,20.0
5570670,1525675880,1525675902,22,211,6.10967991988682,4.0,2.0,18.50021095890404
5570671,1525675898,1525675913,15,183,6.204161765270494,4.0,2.0,24.9
5570672,1525675908,1525675942,34,171,11.18893363064942,4.943321262135923,2.2,50.0
5570673,1525675921,1525675943,22,232,10.089740463914017,4.81812656826568,2.0,50.0
5570674,1525675930,1525675954,24,262,9.616957015195847,4.9,4.9,41.0
5570675,1525675948,1525675994,46,168,11.431956246225255,4.9,3.0,50.0
5570676,1525675955,1525675995,40,208,5.76936880179305,2.0,2.0,17.834674492788018
5570677,1525675978,1525675995,17,176,11.755485883792804,5.306591037998765,2.0,50.0
5570678,1525675993,1525676006,13,130,8.287078495482316,5.0,2.0,20.834817929393097
5570679,1525675999,1525676018,19,265,5.425712230322198,5.0,2.0,17.993755033557044
5570680,1525676018,1525676034,16,193,10.650209932018134,5.0,2.0,49.39841288676446
5570681,1525676034,1525676057,23,221,8.841064139797123,5.0,4.0,24.9
5570682,1525676037,1525676057,20,247,7.1568046242590855,3.0,3.0,26.488176590909084
5570683,1525676042,1525676067,25,260,5.962049070003538,2.1659294344827584,2.0,43.800652320501854
5570684,1525676052,1525676094,42,16,46.03576360416165,50.0,20.0,50.0
5570685,1525676069,1525676094,25,135,18.20325717960924,15.0,5.0,51.9
5570686,1525676089,1525676115,26,171,11.787280015933552,5.0,4.0,50.0
5570687,1525676115,1525676154,39,11,33.634729235542814,25.880139611650492,4.9,102.40174686746988
5570688,1525676118,1525676154,36,247,11.56177435802206,10.647866717980296,3.0,20.0
5570689,1525676138,1525676156,18,143,22.322642198742024,15.0,4.0,65.44042728728938
5570690,1525676149,1525676178,29,10,54.390407975923786,50.0,43.91756674316693,91.0
5570691,1525676159,1525676181,22,340,10.651169567322889,4.9,4.9,50.0
5570692,1525676163,1525676181,18,368,5.615408848813242,4.9,4.9,4.9
5570693,1525676172,1525676182,10,162,10.220533085671974,4.9,4.9,50.0
5570694,1525676177,1525676192,15,168,8.74054467233487,4.9413314205445475,4.9,15.0
5570695,1525676187,1525676205,18,22,7.559347701316085,7.630518716071204,4.9,9.783656342461418
5570696,1525676200,1525676252,52,13,0.0,0.0,0.0,0.0
5570697,1525676205,1525676252,47,22,7.469988267234899,7.649443646635525,4.9,8.827635153094143
5570698,1525676216,1525676273,57,183,6.570764984089833,4.9,3.0,16.85001176470582
5570699,1525676247,1525676274,27,155,17.176164268349268,12.943029543309597,5.0,50.0
5570700,1525676258,1525676275,17,293,6.554847310348618,1.0,1.0,41.0
5570701,1525676265,1525676285,20,357,8.278639344857915,4.9,4.9,20.0
5570702,1525676271,1525676286,15,282,7.07411399288,4.9,4.9,17.358418286394286
5570703,1525676284,1525676336,52,258,9.256759041822852,4.0,3.0,39.52122493075415
5570704,1525676314,1525676350,36,170,14.261626555560248,11.97991239224138,4.0,50.0
5570705,1525676327,1525676362,35,263,7.50814038591205,4.0,4.0,30.599740442804425
5570706,1525676360,1525676388,28,82,15.581241131793151,12.325105384615386,5.2150485072219235,50.0
5570707,1525676367,1525676389,22,299,8.785306481384454,4.9,4.9,48.95994774998361
5570708,1525676382,1525676409,27,260,7.334475293976965,4.0,4.0,20.443318698057052
5570709,1525676392,1525676420,28,45,22.530079991799706,15.0,12.0,54.38568749999993
5570710,1525676413,1525676421,8,177,7.736677106329147,5.0,4.0,20.0
5570711,1525676417,1525676440,23,298,6.416181218951104,4.9,4.0,12.0
5570712,1525676432,1525676464,32,288,8.037859082342052,1.0,1.0,43.81774400465791
5570713,1525676453,1525676474,21,83,13.746673347944323,11.978751895088426,4.9,26.44103136531359
5570714,1525676468,1525676484,16,227,11.225262974567324,7.053723836999653,4.0,44.17746999999998
5570715,1525676481,1525676505,24,154,14.034830779083808,5.455882086139986,4.0,48.219723307939546
5570716,1525676494,1525676505,11,132,22.99362388931944,12.0,4.9,85.61492483784814
5570717,1525676498,1525676516,18,347,12.67218266482775,4.9,4.9,55.9
5570718,1525676512,1525676525,13,250,9.9090290145885,4.0,4.0,47.32169598246729
5570719,1525676518,1525676546,28,111,10.77569100006936,5.0,4.0,20.18059523809524
5570720,1525676523,1525676548,25,250,11.251443874362261,4.0,4.0,41.0
5570721,1525676537,1525676567,30,212,10.695646331374569,4.0,4.0,41.0
5570722,1525676558,1525676586,28,108,19.19454445180969,12.335775645756453,5.051861128005393,54.0
5570723,1525676573,1525676587,14,55,28.056157772286404,17.1697794117647,12.0,66.62722089552231
5570724,1525676585,1525676614,29,229,6.564416816889019,4.9,1.0,20.0
5570725,1525676611,1525676636,25,198,11.401122994245116,6.009327983787145,4.9,30.0
5570726,1525676636,1525676645,9,174,17.490023931597726,12.0,1.0,55.08750805662577
5570727,1525676644,1525676658,14,254,8.28881045660717,4.0,4.0,28.0
5570728,1525676656,1525676667,11,96,5.888508110789381,4.0,1.0,27.352181839999986
5570729,1525676658,1525676678,20,228,11.897485775307521,5.0,4.9,50.0
5570730,1525676664,1525676700,36,375,5.012278915856095,4.9,4.9,4.9
5570731,1525676700,1525676724,24,94,46.11890978126523,50.0,20.16096225375396,58.521810285582276
5570732,1525676717,1525676732,15,169,19.0554347403897,14.36674306640625,1.0,50.0
5570733,1525676726,1525676759,33,40,51.2598464010695,50.0,20.422962636987315,100.78666933774835
5570734,1525676740,1525676759,19,166,15.478068188643697,4.0,4.0,50.0
5570735,1525676743,1525676777,34,188,7.426685347120513,5.0,4.0,17.303583123612135
5570736,1525676759,1525676809,50,168,17.134296727898622,7.0,4.9,50.0
5570737,1525676805,1525676820,15,231,20.46660763683728,12.0,4.9,50.0
5570738,1525676813,1525676864,51,189,6.925731651754033,4.9,4.0,15.0
5570739,1525676863,1525676904,41,141,25.6305611973799,21.0,5.158758047191012,57.98417053475503
5570740,1525676864,1525676905,41,173,33.70954817223181,50.0,5.0,50.0
5570741,1525676869,1525676905,36,221,5.922235767570428,4.9,4.0,15.721172046754536
5570742,1525676873,1525676906,33,31,28.486888077690597,15.0,12.751505589810556,50.067151290375236
5570743,1525676878,1525676917,39,236,4.395600327598106,4.0,4.0,8.177971135764947
5570744,1525676916,1525676931,15,164,25.44470975395738,14.864296206275053,4.9,55.601742315932704
5570745,1525676925,1525676946,21,14,4.050656798956342,4.0,2.0,5.1001895392
5570746,1525676938,1525676976,38,155,12.998802483802622,5.0,4.0,50.0
5570747,1525676976,1525677001,25,161,18.445587195307308,10.885369409981655,4.0,58.26601731601722
5570748,1525677000,1525677060,60,122,14.544187508297279,5.446966110436892,4.0,50.0
5570749,1525677058,1525677075,17,222,48.559380460685865,50.0,7.0,60.7273555337904
5570750,1525677065,1525677075,10,133,6.765652414343303,5.923486453443618,4.9,15.75895358984529
5570751,1525677069,1525677088,19,360,6.062437062730225,4.9,4.9,12.12583720534629
5570752,1525677084,1525677103,19,221,20.841600776757755,5.704408825338254,4.9,50.30168669728029
5570753,1525677096,1525677111,15,169,9.928888187530495,4.0,4.0,50.0
5570754,1525677102,1525677122,20,248,8.460586425646301,3.988456863468636,1.0,50.0
5570755,1525677120,1525677133,13,207,5.738934318454566,4.0,3.0,12.439960567176787
5570756,1525677130,1525677146,16,168,10.051769547886845,6.0,3.0,24.9
5570757,1525677146,1525677167,21,217,6.841712463279047,4.0,3.0,24.9
5570758,1525677160,1525677168,8,106,13.192529468811765,12.0,3.0,46.3610781216672
5570759,1525677168,1525677193,25,265,9.565170070823482,4.033132,1.0,26.839233630568035
5570760,1525677192,1525677212,20,100,39.53073611153382,41.0,21.963551252418707,55.9
5570761,1525677211,1525677245,34,118,13.187208501845062,9.8,4.9,54.20361928335981
5570762,1525677246,1525677260,14,239,9.031665731130706,4.9,1.0,41.0
5570763,1525677259,1525677270,11,174,10.163052816156343,6.0,3.0,30.0
5570764,1525677266,1525677279,13,240,9.961104523608018,4.0,3.0,58.307065285954124
5570765,1525677271,1525677288,17,226,6.076233812888093,3.800824877638214,3.0,15.0
5570766,1525677281,1525677289,8,230,11.129999043762387,4.9,4.9,28.0
5570767,1525677285,1525677332,47,355,6.371025614355878,4.9,4.9,12.048611635693135
5570768,1525677332,1525677342,10,88,28.673085609467233,21.33971151454862,11.964322245343256,62.4688252930158
5570769,1525677336,1525677353,17,160,6.225355843455404,5.0,3.0,11.16398479624606
5570770,1525677351,1525677374,23,188,15.084187339482714,7.254225714285713,3.0,50.0
5570771,1525677375,1525677394,19,269,17.06795864978856,6.0,4.9,50.0
5570772,1525677387,1525677403,16,188,7.690282020514671,5.0,4.9,15.0
5570773,1525677392,1525677403,11,164,6.326810666712389,3.0138521243042375,1.0,33.72269741697408
5570774,1525677398,1525677411,13,270,3.8479017531456394,3.0,1.0,6.139086618838232
5570775,1525677406,1525677428,22,195,12.270414675568928,6.925879999999997,4.0,50.0
5570776,1525677425,1525677446,21,183,7.712845738979057,4.9,3.0,20.0
5570777,1525677440,1525677456,16,193,14.064441582166522,4.0,1.0,57.582874143835596
5570778,1525677449,1525677465,16,71,6.268986160617355,4.0,1.0,25.85049805312623
5570779,1525677462,1525677474,12,140,22.27384140402347,15.0,4.0,54.003501066481554
5570780,1525677472,1525677506,34,126,34.357056781317944,50.0,3.0,50.0
5570781,1525677501,1525677516,15,110,50.64576721147507,50.0,50.0,54.467529007633566
5570782,1525677515,1525677549,34,171,29.154110149103758,28.0,0.0,50.0
5570783,1525677547,1525677566,19,194,8.344993107105251,6.0,5.0,19.189297013574652
5570784,1525677558,1525677600,42,129,12.757880919632907,5.491643688405797,4.0,55.58803171402383
5570785,1525677601,1525677619,18,199,15.55556076206218,10.0,4.0,50.01573142644418
5570786,1525677614,1525677630,16,112,10.118041489311008,5.0,3.0,41.0
5570787,1525677628,1525677656,28,148,10.30697614698729,4.0,3.0,50.0
5570788,1525677652,1525677674,22,25,31.146410638402102,40.0,2.0,68.8342396694214
5570789,1525677658,1525677684,26,106,10.465784795630416,4.0,3.0,33.123781981981736
5570790,1525677669,1525677684,15,156,9.843860522279723,6.0,4.0,40.03024843417918
5570791,1525677673,1525677695,22,146,5.495046087137562,4.0,4.0,6.790686374664792
5570792,1525677691,1525677705,14,107,9.325570788952403,6.0,4.0,16.212596820045878
5570793,1525677697,1525677714,17,114,6.158441231532708,4.0,2.5495674611714354,13.68609592326138
5570794,1525677701,1525677725,24,219,4.753772817561913,2.002,2.0,9.452814959259195
5570795,1525677711,1525677735,24,142,10.7214470482143,6.051885396898866,2.0,38.70975836578448
5570796,1525677732,1525677744,12,213,10.196434295204607,6.0,3.0,50.0
5570797,1525677736,1525677745,9,142,9.47707084284542,4.0,4.0,55.93652260869564
5570798,1525677742,1525677775,33,154,7.4601370659195485,6.0,4.0,15.0
5570799,1525677774,1525677784,10,168,15.996227647923025,12.0,4.0,50.0
5570800,1525677781,1525677822,41,111,5.948106988668401,4.0,2.0002721854251013,15.0
5570801,1525677821,1525677831,10,159,17.780430543176312,11.364109904599571,3.609635627090751,60.039354368085206
5570802,1525677827,1525677850,23,137,12.762737876488176,8.916111036045974,1.0,50.0
5570803,1525677841,1525677861,20,192,13.289199623649193,6.0,4.0,50.0
5570804,1525677848,1525677871,23,267,3.604626951342993,2.0,1.0,7.046552881733644
5570805,1525677862,1525677872,10,173,12.249991197432132,6.0,2.0,60.44550254652302
5570806,1525677868,1525677882,14,172,6.616712550070924,4.0,4.0,20.691750106639603
5570807,1525677874,1525677891,17,120,6.953865788684515,3.0,3.0,50.0
5570808,1525677886,1525677892,6,115,8.157148155891647,5.0,4.0,15.0
5570809,1525677888,1525677901,13,16,39.83920254921685,22.0,9.8,112.9
5570810,1525677899,1525677913,14,186,7.7672124652158345,5.433204824935952,4.0,22.0
5570811,1525677907,1525677922,15,30,12.506939907530516,6.0,6.0,40.54429889298893
5570812,1525677912,1525677932,20,113,3.837109310896045,3.0,3.0,4.9
5570813,1525677915,1525677943,28,231,5.63810775984384,3.0,2.0,18.501710052008097
5570814,1525677933,1525677952,19,141,12.7084417719558,6.066836036036035,3.0,50.0
5570815,1525677937,1525677953,16,137,6.988191540902009,4.0,3.0,25.523762619483033
5570816,1525677944,1525677986,42,192,6.374513555204583,2.2,2.0,26.927941801801754
5570817,1525677979,1525678006,27,225,14.052793050841876,10.0,1.0,50.0
5570818,1525677993,1525678016,23,191,11.155923662993553,5.7197836533180775,1.0,50.0
5570819,1525678001,1525678017,16,170,13.765571562627754,3.204680729166666,3.0,50.0
5570820,1525678005,1525678027,22,232,3.4794214583395813,2.0,2.0,4.452033157894735
5570821,1525678015,1525678039,24,108,8.945684101298674,5.063393777777778,3.0,49.61757631066348
5570822,1525678021,1525678040,19,24,4.009613150486316,3.0082222488038277,3.0,7.722728281249981
5570823,1525678028,1525678088,60,242,5.508120431604876,2.0,2.0,40.56047567567537
5570824,1525678042,1525678089,47,110,11.53174968714222,6.0,2.2,55.9
5570825,1525678052,1525678089,37,107,5.208251935460531,1.0,1.0,30.0
5570826,1525678060,1525678089,29,176,7.007685881107916,3.0,2.0,32.25768970062232
5570827,1525678065,1525678090,25,182,12.206746397830921,2.002,2.0,60.0
5570828,1525678068,1525678090,22,23,4.195813313281709,4.0,3.0,7.426009585343553
5570829,1525678081,1525678090,9,140,7.419823346330005,4.0719536846113495,2.0,17.921613970588197
5570830,1525678084,1525678105,21,146,5.458290057200654,2.002,2.0,12.200424624
5570831,1525678093,1525678138,45,207,8.251422017378319,2.45,2.0,50.0
5570832,1525678135,1525678151,16,380,2.0410661098349134,1.0,1.0,1.0
5570833,1525678148,1525678159,11,184,13.413992048981305,11.981815917487685,4.0,41.0
5570834,1525678153,1525678169,16,226,4.604485701286006,3.0,2.0,7.855554108045976
5570835,1525678157,1525678179,22,248,3.75199948859798,2.0,1.0,14.531207850185949
5570836,1525678175,1525678198,23,132,9.909127108910134,6.0,2.0,27.80555673851153
5570837,1525678189,1525678210,21,194,7.547790785576429,2.2,2.0,47.2173408247256
5570838,1525678208,1525678220,12,150,14.237921521384132,7.0,2.0,50.35185357142858
5570839,1525678216,1525678242,26,256,2.0,2.0,2.0,2.0
5570840,1525678234,1525678259,25,160,24.650741039512734,15.0,4.0,60.106185226019846
5570841,1525678238,1525678259,21,241,2.2034947108614946,2.0,1.0,4.0
5570842,1525678255,1525678295,40,168,20.835505358750133,12.0,2.0,48.112112442199134
5570843,1525678295,1525678307,12,156,27.32170584992087,19.33283991228069,6.0,51.9
5570844,1525678305,1525678331,26,283,3.231251851707457,1.0,1.0,6.0
5570845,1525678330,1525678348,18,148,16.86666861139242,15.0,4.9,50.0
5570846,1525678341,1525678372,31,210,9.002255005885662,4.0,1.0,50.69068770789527
5570847,1525678368,1525678416,48,185,17.393396524406196,10.0,4.0,49.97894878826569
5570848,1525678413,1525678425,12,201,21.057794302903645,12.0,5.208347536842106,58.690489210559264
5570849,1525678424,1525678435,11,90,7.550820868472356,5.855367600523486,3.8,15.0
5570850,1525678434,1525678472,38,134,8.835591369263405,6.0,2.002,28.664259999999995
5570851,1525678470,1525678480,10,156,22.672448962323493,13.216599470522999,5.667663446969697,60.822951714005875
5570852,1525678476,1525678501,25,88,4.012534020159738,4.0,2.0,4.0
5570853,1525678495,1525678511,16,167,27.05164035259769,15.28228125698127,4.0,50.0
5570854,1525678511,1525678601,90,212,6.495066547758507,4.0,2.0,14.671582527339002
5570855,1525678600,1525678617,17,204,34.18608428272573,28.0,10.0,100.0
5570856,1525678615,1525678637,22,178,9.584505537039204,6.0,5.0,20.0
5570857,1525678630,1525678654,24,157,8.132488661656435,4.0,1.0,22.93577142857115
5570858,1525678642,1525678671,29,128,12.030329389983459,5.0,4.0,40.042042192335146
5570859,1525678670,1525678690,20,379,1.1089349989413508,1.0,1.0,1.0
5570860,1525678688,1525678721,33,188,26.513587992475117,15.0,5.6875,56.7584330348743
5570861,1525678710,1525678731,21,210,11.689958823716397,6.0,1.0,55.25059202494593
5570862,1525678716,1525678740,24,195,7.156406091729543,4.0,3.0,33.88725516827566
5570863,1525678733,1525678762,29,81,18.53260308857179,15.0,5.0,50.0
5570864,1525678754,1525678780,26,192,10.627458539222518,6.0,4.0,50.0
5570865,1525678779,1525678816,37,29,27.59874015744297,30.560928104575165,2.4355533714285715,60.64862626156984
5570866,1525678815,1525678883,68,162,27.472357270967006,20.0,15.0,50.07948724040036
5570867,1525678882,1525678894,12,184,18.576693014766565,15.0,2.0,50.0
5570868,1525678893,1525678912,19,107,13.748503371280952,11.815998944557004,6.0,49.91659703942105
5570869,1525678912,1525678932,20,84,11.955193854153572,5.995667179034863,5.0,50.0
5570870,1525678929,1525678952,23,145,20.96096768738762,14.479229833984373,5.0,50.0
5570871,1525678946,1525678963,17,128,10.64246446400402,5.147237095541518,4.0,51.34066092522736
5570872,1525678955,1525678975,20,139,9.068227741695477,4.0,3.184334151597281,41.0
5570873,1525678965,1525678986,21,139,5.734825566375089,3.0,2.002,15.0
5570874,1525678969,1525678986,17,40,29.28266487673274,22.073996040429225,18.083826165488567,50.0
5570875,1525678981,1525678995,14,126,6.326357329185177,5.030357221073123,2.0,14.205104325637908
5570876,1525678984,1525679004,20,222,3.9374652137026267,2.0,2.0,6.866949334677404
5570877,1525679000,1525679014,14,137,7.177963885633402,6.0,1.0,20.88933225724869
5570878,1525679007,1525679025,18,377,1.0,1.0,1.0,1.0
5570879,1525679012,1525679026,14,40,9.264105862335576,6.680095329087049,4.459097333333334,15.29278401997497
5570880,1525679018,1525679035,17,145,6.937503902460329,4.0,2.2,25.0
5570881,1525679026,1525679036,10,380,1.1086474501108647,1.0,1.0,1.0
5570882,1525679031,1525679064,33,244,7.688078660596245,6.0,1.0,24.579967777777732
5570883,1525679048,1525679075,27,379,1.0543840177580466,1.0,1.0,1.0
5570884,1525679066,1525679086,20,161,16.957842080261457,7.781164897185933,1.0,50.0
5570885,1525679087,1525679108,21,104,14.246823478340819,7.0,6.0322056955645165,50.0
5570886,1525679094,1525679108,14,66,6.420775228155401,5.553996992770253,1.0,7.0
5570887,1525679101,1525679118,17,42,12.219136142712086,7.0,5.729546455464074,52.70076118577494
5570888,1525679113,1525679140,27,212,7.56134957455183,4.1,3.6453286523910617,24.45424814814815
5570889,1525679132,1525679153,21,152,11.87502710304896,5.918889716941489,3.0,50.0
5570890,1525679149,1525679164,15,237,7.645837096871621,5.7330111769051095,2.0,15.925081955990219
5570891,1525679161,1525679174,13,156,10.069004390996703,6.0,2.0281344219886823,20.920892989301414
5570892,1525679170,1525679185,15,39,10.60337882779788,6.0,5.812876766491025,41.0
5570893,1525679175,1525679220,45,247,6.237129935249135,4.0,1.0,12.542024166666645
5570894,1525679192,1525679221,29,380,1.1118022244478414,1.0,1.0,1.0
5570895,1525679204,1525679222,18,157,12.091412678931277,6.0,2.0,52.73489781620493
5570896,1525679210,1525679222,12,230,16.73957853247494,20.0,2.0,48.62552522522467
5570897,1525679220,1525679233,13,19,7.975355771541119,8.0,4.0,22.58976331271304
5570898,1525679229,1525679244,15,55,17.988029634486665,6.0,5.0,66.58835259549458
5570899,1525679232,1525679254,22,10,2.890858293130449,3.742913248793463,1.0,4.210001
5570900,1525679245,1525679263,18,229,13.03421908696457,6.0,2.0,52.08340154109588
5570901,1525679257,1525679275,18,57,16.828513860881156,6.153271742652164,5.0,55.0
5570902,1525679273,1525679283,10,172,7.239932230154391,4.0,2.0,31.6727716765033
5570903,1525679279,1525679292,13,380,1.0850781546439563,1.0,1.0,1.0
5570904,1525679289,1525679310,21,73,16.1961087394455,6.952794095940954,5.245960881119365,50.0
5570905,1525679309,1525679336,27,198,13.090731095289991,5.109908641975309,2.0,50.0
5570906,1525679335,1525679344,9,220,15.241367441760454,6.0,2.0,50.0
5570907,1525679340,1525679353,13,148,11.429524630165592,6.0,2.0,50.0
5570908,1525679345,1525679384,39,114,7.187882629575449,4.0,2.0,24.399771429426828
5570909,1525679373,1525679392,19,200,14.187868239489505,6.0,2.0,50.0
5570910,1525679381,1525679393,12,145,28.053662796405543,28.0,4.0,50.0
5570911,1525679385,1525679401,16,219,5.71986133135392,2.0,2.0,50.0
5570912,1525679391,1525679410,19,380,1.0664171630383217,1.0,1.0,1.0
5570913,1525679401,1525679410,9,86,18.536317276948804,11.977952757005863,5.255553907416887,50.0
5570914,1525679406,1525679434,28,26,5.638435851522044,4.067228915662651,2.101008358763434,36.075926386471
5570915,1525679408,1525679452,44,217,10.319094671431499,2.0,2.0,50.0
5570916,1525679442,1525679467,25,195,21.695755903765516,11.86600273245074,4.0,50.258073918557415
5570917,1525679458,1525679475,17,53,39.65458008117527,18.41648,0.0,226.89512290680244
5570918,1525679471,1525679485,14,164,11.285034742529724,6.0,2.002,50.0
5570919,1525679481,1525679497,16,134,13.22910949469949,7.0,2.002,51.9
5570920,1525679495,1525679517,22,119,7.211896589231597,2.2,2.002,34.41376310483869
5570921,1525679497,1525679532,35,273,3.0613546400820995,1.0,1.0,1.0
5570922,1525679501,1525679532,31,236,9.136357200865904,2.2,2.0,50.0
5570923,1525679517,1525679532,15,41,23.84517078490468,13.859490673961702,12.0,51.894709904030705
5570924,1525679525,1525679561,36,191,6.3969964396716374,5.5,2.0,10.0
5570925,1525679557,1525679584,27,247,13.652661188988978,1.0,1.0,54.0
5570926,1525679582,1525679608,26,12,53.30985257070703,50.0,40.076756,101.9668329272727
5570927,1525679600,1525679658,58,32,41.07482157768984,30.0,22.573420173913043,90.0
5570928,1525679657,1525679666,9,223,30.478218124797266,20.0,15.0,53.93349078397938
5570929,1525679660,1525679666,6,137,11.447405279866457,8.0,5.0,50.15511130434782
5570930,1525679662,1525679674,12,208,2.064113489111029,1.0,1.0,4.0
5570931,1525679665,1525679682,17,186,11.475501017113038,5.4253580748175185,3.0,50.0
5570932,1525679674,1525679690,16,140,4.982896564898294,2.2,2.002,11.417748561983469
5570933,1525679682,1525679700,18,112,10.491657460027364,1.0,1.0,50.0
5570934,1525679695,1525679708,13,43,23.834488897347455,1.0,1.0,111.0
5570935,1525679705,1525679717,12,198,10.971850475728079,6.0,2.0,45.577761556099624
5570936,1525679711,1525679737,26,232,4.884034359970533,2.0,2.0,20.325027313432834
5570937,1525679736,1525679747,11,138,11.789461750445785,1.0,1.0,52.528489448275856
5570938,1525679744,1525679762,18,42,27.096012063086963,20.40079415519538,1.0,91.0
5570939,1525679754,1525679779,25,87,26.491188424476455,14.30562191780822,12.0,50.0
5570940,1525679774,1525679811,37,252,6.698185323752067,6.0,1.0,20.2065249086132
5570941,1525679810,1525679824,14,272,5.8632028837797545,3.0,1.0,7.0
5570942,1525679822,1525679833,11,169,14.625367308634072,7.075314102007139,1.0,56.09320458333332
5570943,1525679828,1525679876,48,11,51.014746611815035,47.35857612356968,20.73159673804781,101.36652345679012
5570944,1525679833,1525679877,44,150,4.893007199167441,4.0,3.0,12.895660589582388
5570945,1525679842,1525679877,35,253,5.152614010168798,2.0,1.0,21.523210273585278
5570946,1525679857,1525679909,52,346,6.834565564891017,1.0,1.0,41.0
5570947,1525679907,1525679924,17,284,12.21490288561174,2.001731627530364,1.0,50.0
5570948,1525679925,1525679932,7,179,11.123190797793338,6.2,1.0,50.0
5570949,1525679929,1525679941,12,23,14.96592834199569,4.5399016939235555,2.002,50.0
5570950,1525679941,1525679950,9,190,10.252896634906987,5.6875,3.0,46.7375175438596
5570951,1525679947,1525679974,27,215,11.77606208327679,1.0,1.0,50.60946787
5570952,1525679957,1525679974,17,98,15.991146141161378,6.185240638741032,1.0,85.53377361388414
5570953,1525679965,1525679992,27,143,14.805939128770866,12.210920048602674,1.0,41.0
5570954,1525679991,1525680050,59,171,5.4888065076374435,4.9513485113477,3.0,10.721539999999987
5570955,1525680048,1525680095,47,198,16.838605881755143,12.0,4.0,54.86865178571425
5570956,1525680095,1525680107,12,206,16.007070456983023,8.96419266055046,4.0,50.0
5570957,1525680102,1525680128,26,48,22.59871965228395,20.0,12.0,53.76310701030928
5570958,1525680128,1525680151,23,123,9.431913420301075,6.0,4.0,20.0
5570959,1525680150,1525680165,15,375,0.954069721245887,1.0,0.1,1.0
5570960,1525680163,1525680188,25,163,11.85882696394133,6.0,4.0,50.0
5570961,1525680188,1525680206,18,213,10.41241955074838,3.0,1.0,44.56596410748558
5570962,1525680197,1525680206,9,112,15.107734711131885,12.046477488,4.0,50.0
5570963,1525680206,1525680230,24,156,10.567103924091125,6.0,2.2,32.54212381167844
5570964,1525680228,1525680241,13,209,7.403832963191615,4.0,1.0,40.25936407422799
5570965,1525680237,1525680250,13,162,11.642646603096118,6.0,2.2,41.0
5570966,1525680243,1525680267,24,15,4.159880114293325,0.0,0.0,45.65846237392448
5570967,1525680248,1525680276,28,58,7.8447259630557,4.6555751477513825,4.0,25.212391872065727
5570968,1525680275,1525680298,23,367,3.0816886015198084,1.0,1.0,21.474523636363628
5570969,1525680288,1525680298,10,127,35.577901127213444,21.0,1.0,80.0
5570970,1525680296,1525680322,26,171,4.309101436917086,4.0,2.002,7.0
5570971,1525680320,1525680389,69,146,19.23042932578401,15.0,2.0,59.83869999999999
5570972,1525680331,1525680389,58,79,12.893897778083716,7.158944148936169,4.0,20.878653958333327
5570973,1525680337,1525680390,53,149,3.458731580082699,3.0,2.0,4.0
5570974,1525680357,1525680390,33,190,10.873366163346427,6.0,2.0,22.66316432851237
5570975,1525680385,1525680390,5,97,15.38681550247979,10.0,4.0,50.0
5570976,1525680389,1525680418,29,52,15.606290646670375,20.0,4.0,28.0
5570977,1525680416,1525680428,12,157,11.23164419989117,6.0,2.2,50.0
5570978,1525680427,1525680440,13,185,17.51403341936645,11.698291666666615,4.0,50.0
5570979,1525680440,1525680462,22,188,14.792053560267393,6.0,4.0,50.0
5570980,1525680461,1525680471,10,153,13.359129003051294,11.457046943765281,4.0,30.0
5570981,1525680469,1525680490,21,379,1.0889265297480415,1.0,1.0,1.0
5570982,1525680481,1525680491,10,184,21.45309736338901,7.943225641730912,3.0,50.0
5570983,1525680487,1525680491,4,203,8.315349908970871,3.0,2.0,24.010596933962262
5570984,1525680489,1525680501,12,168,4.4180787400305945,3.0,2.0,9.851061715959535
5570985,1525680496,1525680514,18,117,7.106745911706044,4.0,2.0,26.988583736068755
5570986,1525680513,1525680528,15,210,17.007390361106687,7.123022340425531,2.002,50.0
5570987,1525680526,1525680539,13,173,13.39239945857192,6.0,2.0,49.76680416018989
5570988,1525680535,1525680547,12,23,16.152180691236733,6.0,6.0,50.0
5570989,1525680549,1525680557,8,228,14.178118266589967,6.155054292987734,2.0,50.0
5570990,1525680553,1525680603,50,206,13.250228125313397,11.080258823529404,1.0,50.0
5570991,1525680603,1525680638,35,194,15.950264159659016,6.0,2.2,50.0
5570992,1525680638,1525680658,20,161,33.909169173080485,36.016357219521424,0.0,61.0
5570993,1525680656,1525680684,28,211,1.9371479282011166,1.0,1.0,4.0
5570994,1525680684,1525680699,15,283,24.102252471680305,11.992347675492612,8.0,61.0
5570995,1525680698,1525680720,22,379,1.0987791342952276,1.0,1.0,1.0
5570996,1525680715,1525680729,14,339,17.626560602015875,1.0,1.0,50.0
5570997,1525680723,1525680761,38,135,12.411461338418379,9.0,5.0,21.81877981683278
5570998,1525680761,1525680770,9,154,15.008142758763029,6.0,4.0,55.091194778315426
5570999,1525680764,1525680778,14,102,6.498485228052545,4.0,3.0,33.541488791869945
5571000,1525680770,1525680779,9,171,8.425519260242735,4.0,2.002,20.0
5571001,1525680777,1525680797,20,252,17.234621872039757,10.52862380952381,1.0,54.0
5571002,1525680798,1525680829,31,165,8.005927774814074,3.0,2.0,20.0
5571003,1525680829,1525680860,31,53,15.669802519353942,6.072483915760241,3.0,57.444539553867486
5571004,1525680859,1525680903,44,122,21.19247444098474,12.10972608,9.084917668269231,51.102397756324365
5571005,1525680903,1525680914,11,206,50.313588229744795,50.0,28.0,61.0
5571006,1525680911,1525680945,34,175,15.156249848496532,20.0,5.193171576576577,27.294826805241094
5571007,1525680944,1525680966,22,183,11.728212664159006,5.069838615574784,1.0,50.0
5571008,1525680963,1525680993,30,103,8.75746604434171,5.0,4.0,20.62409485840848
5571009,1525680991,1525681002,11,42,18.59098334165512,7.119507167431193,5.31202,52.24088464730289
5571010,1525681001,1525681020,19,191,9.14331050860318,7.0,3.0,20.0
5571011,1525681017,1525681031,14,211,29.768171615415923,20.0,4.0,61.0
5571012,1525681025,1525681039,14,81,10.589899678060751,7.0,4.0,22.57200670344767
5571013,1525681030,1525681049,19,380,1.0581021543909945,1.0,1.0,1.0
5571014,1525681039,1525681060,21,269,6.894793734745302,3.0,1.0,29.91306799107143
5571015,1525681059,1525681070,11,204,15.333215177608094,12.0,4.0,50.0
5571016,1525681068,1525681085,17,138,4.822545678938673,3.0,2.2,10.0
5571017,1525681084,1525681113,29,207,9.531512174485766,6.0,2.0,20.86755940532081
5571018,1525681112,1525681123,11,182,11.185631183200492,4.911909435293255,2.0,50.0
5571019,1525681121,1525681131,10,170,20.101522412445203,6.0,4.0,61.0
5571020,1525681130,1525681140,10,94,6.826441467258399,4.0,2.0,15.593283883495141
5571021,1525681136,1525681150,14,212,5.444007771111524,3.0,2.0,7.532721440677943
5571022,1525681145,1525681410,265,132,4.822036161319499,3.0,2.0,20.0
5571023,1525681160,1525681442,282,378,1.0667691166339888,1.0,1.0,1.0
5571024,1525681168,1525681443,275,90,15.118285123674298,6.0,5.0,61.0
5571025,1525681174,1525681443,269,132,6.261798439488678,5.0,4.0,8.804299831590956
5571026,1525681183,1525681443,260,211,5.047729979241243,2.002,2.0,35.88199499538823
5571027,1525681195,1525681443,248,17,6.196960121044816,5.9707113155868035,1.0,8.932515820575983
5571028,1525681198,1525681443,245,182,9.777546563099255,6.0,4.0,30.646322403983365
5571029,1525681206,1525681444,238,196,6.931605497240721,5.720379557549194,2.0,23.31664864864861
5571030,1525681239,1525681444,205,161,16.16474763068691,10.0,3.0,50.259698505388485
5571031,1525681250,1525681446,196,380,1.0442781086922144,1.0,1.0,1.0
5571032,1525681260,1525681446,186,76,48.40095059252355,50.0,20.0,61.27841578947366
5571033,1525681268,1525681446,178,140,8.79175673286394,6.0,2.318307638618714,30.877513513513488
5571034,1525681275,1525681447,172,191,9.375267686025861,2.0,2.0,50.0
5571035,1525681279,1525681447,168,42,54.02248265523232,50.0,50.0,61.0
5571036,1525681291,1525681447,156,287,11.582197438712388,1.0,1.0,50.0
5571037,1525681295,1525681448,153,120,8.362701722364209,6.0,4.0,17.894131979695416
5571038,1525681305,1525681448,143,103,10.987809378022485,1.0,1.0,61.0
5571039,1525681308,1525681448,140,152,7.166767374578774,6.0,3.0,12.706108023690755
5571040,1525681318,1525681448,130,97,6.845243517493315,5.0,1.0,20.0
5571041,1525681322,1525681449,127,82,17.846063917813257,1.0,1.0,61.0
5571042,1525681332,1525681449,117,41,17.248821709244606,12.219961603888214,1.0,61.0
5571043,1525681340,1525681449,109,115,6.9598942275540665,6.0,3.0,23.447215686274493
5571044,1525681344,1525681449,105,89,15.293979627840168,11.719947603070866,1.0,61.0
5571045,1525681358,1525681449,91,101,6.995000249679282,3.0,3.0,23.112860360360337
5571046,1525681391,1525681449,58,152,32.09775726503276,21.23318321119254,5.0,61.0
5571047,1525681416,1525681450,34,185,11.370846175226571,6.0,3.0,54.442350131182764
5571048,1525681425,1525681451,26,215,9.809340694021985,4.752189444229428,2.332,61.0
5571049,1525681441,1525681452,11,212,8.989146693354432,4.0,2.0,28.198375976562495
5571050,1525681450,1525681498,48,235,6.6900952320794715,5.521173973223682,1.0,13.321466231527092
5571051,1525681480,1525681499,19,174,11.041945180099196,5.944198355328771,2.051139291906318,41.0
5571052,1525681483,1525681500,17,370,5.7341859297205495,1.0,1.0,50.0
5571053,1525681493,1525681509,16,221,6.311935769934126,3.0,2.0,11.791530666666649
5571054,1525681506,1525681516,10,52,24.94408521379581,14.039414580801944,12.0,50.0
5571055,1525681508,1525681517,9,85,13.908982681743984,13.392583333333347,1.0,38.39899546642269
5571056,1525681510,1525681547,37,128,7.524764134511645,6.0,3.18,11.657531315199996
5571057,1525681541,1525681581,40,83,11.284741384537714,6.125064892386022,4.0,48.64856473684207
5571058,1525681581,1525681590,9,185,18.06301482417077,7.915267142857143,4.0,51.76016840353018
5571059,1525681589,1525681598,9,114,19.539039792300766,6.0,4.0,50.0
5571060,1525681595,1525681625,30,286,2.9027650220489662,1.0,1.0,5.665538857490861
5571061,1525681618,1525681646,28,105,12.428019384989108,6.0,4.0,50.0
5571062,1525681642,1525681663,21,175,9.96795550162058,4.0,3.0,41.0
5571063,1525681653,1525681664,11,72,10.949649746567546,5.195893133333334,3.3304256000000008,50.0
5571064,1525681658,1525681679,21,13,14.476338089521255,12.307579502770936,11.940857539622847,34.406218506763125
5571065,1525681664,1525681706,42,11,7.485284529434777,7.550270838548185,3.0,8.0
5571066,1525681696,1525681715,19,378,1.1981195120708896,1.0,1.0,1.0
5571067,1525681711,1525681731,20,162,11.999175863033313,6.0,4.0,41.0
5571068,1525681717,1525681738,21,25,8.56104550932751,4.0,4.0,50.0098565650826
5571069,1525681735,1525681746,11,199,10.27641139221267,4.0,2.1089578387096775,43.26002500907687
5571070,1525681738,1525681757,19,136,12.90965767855248,6.0,2.0347391603053437,50.0
5571071,1525681743,1525681757,14,228,17.40743124673202,2.0,2.0,50.0
5571072,1525681751,1525681774,23,62,9.129487136074859,6.0,1.0,30.0
5571073,1525681767,1525681783,16,72,15.656268380259037,7.539774147530936,5.0,55.5575448444171
5571074,1525681772,1525681784,12,55,5.2176574935919815,4.0,2.0491830534351148,15.056602264621969
5571075,1525681776,1525681792,16,59,7.980128211641622,5.508232918330984,3.1,24.902127306967976
5571076,1525681781,1525681803,22,269,5.486177945726647,1.0,1.0,29.338769684249637
5571077,1525681790,1525681816,26,111,15.71513148929594,11.994629217980295,1.0,50.0
5571078,1525681812,1525681834,22,178,6.496132695322281,3.1776079126858736,2.0,40.0
5571079,1525681828,1525681856,28,109,23.933475486505877,15.599542116504855,0.0,66.0
5571080,1525681855,1525681884,29,5,59.401295731707314,59.54031413612566,20.06025432900433,91.0
5571081,1525681884,1525681896,12,163,12.25091936206466,8.0,4.0,41.0
5571082,1525681896,1525681905,9,155,6.94095904046301,4.0,1.0,31.21661711711699
5571083,1525681900,1525681932,32,73,11.611172003400343,5.2,3.1,61.0
5571084,1525681927,1525681940,13,253,9.173182433053526,4.0,1.0,30.0
5571085,1525681938,1525681975,37,207,12.10897560936321,6.0451627401064565,3.0,61.0
5571086,1525681945,1525682024,79,367,2.7060137740590178,1.0,1.0,14.386476538461531
5571087,1525682024,1525682033,9,194,26.61021921257731,20.0,3.0,61.803201255341854
5571088,1525682031,1525682053,22,296,18.272720285679426,6.93528195329087,4.0,61.0
5571089,1525682052,1525682060,8,249,13.86199433194892,5.0,4.0,76.10591406249988
5571090,1525682055,1525682066,11,70,59.82402356246682,61.0,30.0,111.0
5571091,1525682058,1525682096,38,141,6.148409899112181,4.0,3.0,10.94141988304092
5571092,1525682089,1525682111,22,286,15.990244429731904,9.6984375,1.0,50.0
5571093,1525682111,1525682135,24,239,34.94484572871071,50.0,4.9770899375,61.0
5571094,1525682135,1525682143,8,248,10.05940684605597,5.198815757575757,1.0,50.06617033597191
5571095,1525682142,1525682152,10,169,9.869147895583001,3.13320280856816,3.0,50.0
5571096,1525682149,1525682159,10,33,49.53587676654789,51.9,20.0,91.0
5571097,1525682153,1525682200,47,206,5.397932485841829,4.0,1.0,13.691957534246537
5571098,1525682198,1525682217,19,215,21.71651335696367,12.0,4.0,60.611540825688074
5571099,1525682217,1525682237,20,224,27.494303971467698,15.0,3.34375,91.0
5571100,1525682228,1525682244,16,107,19.97019900078768,6.0,3.0,50.0
5571101,1525682238,1525682280,42,107,7.920506425871416,3.0,3.0,23.795876266666657
5571102,1525682276,1525682282,6,184,27.00324244713033,15.930591550069241,5.265569543732098,61.0
5571103,1525682277,1525682304,27,20,9.163067835836877,8.061887980769232,4.0,20.0
5571104,1525682301,1525682312,11,41,37.21360918201574,41.0,2.0,91.0
5571105,1525682310,1525682340,30,120,8.61042560515022,4.0,3.0,20.841093548993936
5571106,1525682331,1525682341,10,104,12.004670111076956,5.446997686046511,4.0,50.0
5571107,1525682337,1525682361,24,175,9.504762450004206,4.0,2.0,50.0
5571108,1525682353,1525682370,17,254,6.520638041115508,2.0,1.0,35.0
5571109,1525682358,1525682371,13,88,6.535453580674889,4.0,2.0,19.415740233036143
5571110,1525682363,1525682371,8,179,22.097013249506986,6.0,1.2470392098765433,61.0
5571111,1525682367,1525682395,28,124,8.057327632623721,6.0,2.0,12.8654851949142
5571112,1525682393,1525682404,11,212,14.63284458153771,6.0,2.0,61.0
5571113,1525682400,1525682421,21,379,1.1318242343541944,1.0,1.0,1.0
5571114,1525682406,1525682422,16,241,11.069105182417236,6.0,2.0,50.0
5571115,1525682409,1525682422,13,222,4.314734776413881,2.2075151565347024,1.0,6.0
5571116,1525682416,1525682434,18,205,10.203635471103967,3.806033057851238,2.0,39.13758260921259
5571117,1525682437,1525682461,24,221,14.784221057783316,5.0,2.0,60.1821976146789
5571118,1525682454,1525682470,16,172,20.806205466612994,11.500819018860453,4.0,61.0
5571119,1525682466,1525682479,13,177,4.556595696143343,3.0,2.0,6.164773043280182
5571120,1525682473,1525682504,31,106,10.956681915315528,4.0,2.0,50.0
5571121,1525682503,1525682513,10,204,25.129604228758,12.113094192,4.0,61.0
5571122,1525682515,1525682526,11,205,4.183817980422905,3.0,2.0,9.512133577736073
5571123,1525682529,1525682543,14,168,11.035084252643111,6.085074782608696,1.0,50.0
5571124,1525682536,1525682568,32,109,5.19486362203852,4.0,2.0,10.499515755275434
5571125,1525682559,1525682575,16,220,16.74061376371506,2.0,2.0,64.47877431192654
5571126,1525682567,1525682576,9,147,10.408642032491493,5.853411797747439,3.0,50.0
5571127,1525682573,1525682601,28,196,15.17737358415103,2.0,2.0,99.10556454009433
5571128,1525682580,1525682601,21,206,7.220606782906118,4.0,2.0,24.39892252252238
5571129,1525682584,1525682615,31,69,19.98315627357819,4.646917774406032,3.0,61.0
5571130,1525682614,1525682624,10,145,11.895474908304552,6.0,2.0,50.0
5571131,1525682622,1525682641,19,380,1.0653102103210164,1.0,1.0,1.0
5571132,1525682638,1525682650,12,180,17.312553441156247,8.0,3.0,61.0
5571133,1525682645,1525682650,5,223,6.822392500538571,2.1,2.0,26.296979999999962
5571134,1525682650,1525682731,81,195,12.478235524940262,4.0,2.0,61.0
5571135,1525682729,1525682759,30,247,32.7401103582828,24.0,15.0,61.0
5571136,1525682758,1525682775,17,156,15.863519594039587,12.0,6.0,44.085546121323084
5571137,1525682774,1525682796,22,214,11.377369201314712,5.0,1.0,50.38453808392356
5571138,1525682794,1525682805,11,144,13.92045320185002,6.0,4.0,50.0
5571139,1525682804,1525682812,8,150,29.156801402645186,15.0,6.949509558541267,100.60946787
5571140,1525682809,1525682821,12,88,5.738716697030476,4.0,4.0,6.0
5571141,1525682817,1525682837,20,166,6.27240551828685,3.0,3.0,22.47242801418436
5571142,1525682838,1525682865,27,181,12.466667728200518,6.0,4.0,50.0
5571143,1525682857,1525682865,8,157,13.425972499514753,5.5942639339579525,2.0,52.87139568153836
5571144,1525682862,1525682882,20,90,13.215956928550241,6.0,3.0,50.0
5571145,1525682867,1525682883,16,368,94.99545873346705,100.60946787,50.0,100.60946787
5571146,1525682874,1525682892,18,168,8.343339020766777,5.746958213876146,2.0,36.845262863206145
5571147,1525682889,1525682909,20,161,17.070797818065873,7.0,3.0,50.0
5571148,1525682900,1525682917,17,377,1.0,1.0,1.0,1.0
5571149,1525682911,1525682965,54,184,24.923052262450007,15.0,7.0,91.0
5571150,1525682963,1525682983,20,187,21.865005503722053,12.0,7.0,50.0
5571151,1525682981,1525682997,16,379,1.0,1.0,1.0,1.0
5571152,1525682996,1525683031,35,168,10.770037588602106,5.663132330892792,1.0,50.0
5571153,1525683031,1525683060,29,167,13.647293991160955,6.092957744874715,4.0,50.0
5571154,1525683059,1525683069,10,156,13.407812298147048,4.3336242235565905,4.0,57.476
5571155,1525683066,1525683105,39,116,26.117360951218227,7.267777859778597,6.1,90.7404239616958
5571156,1525683103,1525683122,19,141,20.254202351562274,12.0,7.0,51.94974885758414
5571157,1525683120,1525683130,10,202,9.495855939604912,5.0,1.0,41.0
5571158,1525683128,1525683191,63,73,12.828883299710037,7.0,6.1,50.0
5571159,1525683190,1525683216,26,378,1.0,1.0,1.0,1.0
5571160,1525683216,1525683231,15,222,47.231195024899094,50.0,20.0,91.0
5571161,1525683230,1525683242,12,173,8.786798889891367,7.52630753123878,1.0,16.675988078
5571162,1525683235,1525683251,16,32,23.744198336599663,20.0,15.0,52.89997067821294
5571163,1525683247,1525683264,17,77,9.398135687051843,7.0,6.152672522522522,21.0
5571164,1525683263,1525683275,12,134,10.698765802614352,6.0,1.0,50.0
5571165,1525683272,1525683301,29,70,8.042039815904985,4.000000001,4.0,40.94810108173077
5571166,1525683278,1525683310,32,378,1.0,1.0,1.0,1.0
5571167,1525683301,1525683319,18,132,27.07565777565594,30.0,1.0,53.899980233333736
5571168,1525683312,1525683327,15,184,8.341349306769647,6.0,4.0,15.000360286272988
5571169,1525683317,1525683335,18,200,5.8281642025136255,4.0,1.0,10.999912444444433
5571170,1525683329,1525683358,29,135,8.668619304795985,4.0,2.7689096000000006,42.96897832558916
5571171,1525683356,1525683372,16,217,12.338005585237639,6.0,3.0,50.0
5571172,1525683373,1525683382,9,148,8.098559129124029,4.0,2.2194529670229426,29.934183333333277
5571173,1525683378,1525683391,13,187,11.625656216659184,7.0,4.0,50.0
5571174,1525683385,1525683400,15,71,8.12407936093226,5.698384890050897,4.0,24.850309009008903
5571175,1525683396,1525683460,64,161,7.323590172640586,3.0,2.0,34.97270823814177
5571176,1525683460,1525683470,10,200,21.07040017970757,16.275123999999998,1.0,59.22164874836238
5571177,1525683471,1525683488,17,2,98.28044886657216,98.28044886657216,90.0,100.0
5571178,1525683477,1525683496,19,131,10.01096165656472,5.970603387012987,4.0,41.0
5571179,1525683482,1525683505,23,378,1.0,1.0,1.0,1.0
5571180,1525683500,1525683513,13,378,1.0,1.0,1.0,1.0
5571181,1525683505,1525683538,33,145,13.327110545004034,6.0,4.0,50.0
5571182,1525683537,1525683546,9,222,14.830381171521601,6.0,1.0,50.0
5571183,1525683542,1525683586,44,122,6.417998611093876,5.9937539578835795,2.15038176,11.731097601468736
5571184,1525683579,1525683623,44,190,52.83838762273116,50.0,41.0,90.8553301519696
5571185,1525683623,1525683640,17,274,14.964279250601267,12.0,6.1,30.0
5571186,1525683637,1525683670,33,16,42.23889542629525,50.0,0.25,54.663776708804114
5571187,1525683670,1525683687,17,183,26.323488301920232,15.0,5.6875,60.0
5571188,1525683675,1525683696,21,378,1.0,1.0,1.0,1.0
5571189,1525683693,1525683752,59,312,9.70479431474081,1.0,1.0,50.0
5571190,1525683752,1525683761,9,195,38.37640104149303,41.0,10.0,91.0
5571191,1525683759,1525683779,20,82,10.556694158458484,9.877515916058407,5.6875,29.00025776287932
5571192,1525683776,1525683789,13,112,12.781697788076961,6.0,5.0,50.0
5571193,1525683787,1525683799,12,148,8.44199975957753,5.137430681322888,4.0,13.938184282516785
5571194,1525683799,1525683823,24,141,11.898037877828923,5.0,4.0,50.0
5571195,1525683822,1525683839,17,148,10.675489855448479,5.6875,4.0,50.0
5571196,1525683838,1525683856,18,149,10.932499595894383,5.0,4.0,50.80519355764727
5571197,1525683845,1525683866,21,101,8.023215678380579,4.0,4.0,49.21137808276218
5571198,1525683863,1525683909,46,210,22.625933881322425,10.0,6.0,51.9
5571199,1525683869,1525683909,40,98,4.8634897125033865,4.0,4.0,6.185955278870632
5571200,1525683888,1525683909,21,125,13.913690990464424,6.0,5.0,50.0
5571201,1525683898,1525683909,11,20,11.5080288252348,0.0,0.0,50.0629275575775
5571202,1525683904,1525683918,14,378,1.0,1.0,1.0,1.0
5571203,1525683910,1525683941,31,240,10.58244243048764,4.24,1.0,50.836825223880574
5571204,1525683936,1525683964,28,212,10.56256443519996,6.0,1.0,20.008807982086438
5571205,1525683962,1525683976,14,182,19.036957023224925,20.0,4.24,50.0
5571206,1525683971,1525683997,26,133,12.577971805037144,5.0,4.0,50.0
5571207,1525684000,1525684020,20,210,30.580444014020006,20.0,11.334912577319587,50.0
5571208,1525684019,1525684029,10,236,22.28176445815664,20.0,5.0,50.0
5571209,1525684023,1525684044,21,99,7.135679888240253,6.0,4.0,10.0
5571210,1525684044,1525684067,23,136,17.70385788495704,11.327562988043317,4.0,50.0
5571211,1525684066,1525684083,17,166,9.445621131332029,5.149953397803147,4.0,50.0
5571212,1525684082,1525684104,22,193,12.817245664143249,4.0,3.0,50.0
5571213,1525684099,1525684111,12,57,24.49890921075605,13.398675091130013,0.0,100.0
5571214,1525684107,1525684125,18,143,5.417000581883512,4.0,1.0,10.636503786691929
5571215,1525684125,1525684155,30,165,13.68385838277875,8.0,3.0,50.0
5571216,1525684143,1525684156,13,170,9.155941168201942,5.7607566380718955,2.182138342515344,50.0
5571217,1525684155,1525684184,29,151,10.589881132935883,6.0,2.0,50.0
5571218,1525684160,1525684185,25,25,6.699257312589099,5.230273809523809,4.0,6.095559440129449
5571219,1525684170,1525684186,16,375,1.8558421851289832,2.0,1.0,2.0
5571220,1525684181,1525684201,20,184,10.881260264111061,6.0,3.0,50.0
5571221,1525684202,1525684211,9,374,1.422336328626444,1.0,1.0,2.0
5571222,1525684207,1525684220,13,180,1.2416452442159382,1.0,1.0,2.0
5571223,1525684212,1525684273,61,27,2.0,2.0,2.0,2.0
5571224,1525684274,1525684299,25,233,40.9159313104799,50.0,10.0,88.74608109981841
5571225,1525684299,1525684322,23,168,10.796479669579595,8.0,1.0,24.487583654333733
5571226,1525684322,1525684340,18,237,42.31863575342537,50.0,15.0,54.0
5571227,1525684337,1525684349,12,221,17.133286621138815,15.0,6.1,50.0
5571228,1525684348,1525684368,20,222,6.678747523098015,5.0,1.0,21.566146781820272
5571229,1525684367,1525684381,14,230,17.650694030096886,7.501393722878938,4.0,50.0
5571230,1525684380,1525684397,17,183,9.980498594230616,6.0,4.0,50.0
5571231,1525684394,1525684444,50,185,11.01430623852533,4.0,4.0,50.0
5571232,1525684444,1525684464,20,287,22.524480509820293,14.777246148223671,1.0,60.258920861900094
5571233,1525684455,1525684472,17,117,10.058660498377606,6.0,5.0,38.323982353836215
5571234,1525684470,1525684480,10,170,11.859422892960005,5.34740129481645,3.0,51.45136483966782
5571235,1525684477,1525684508,31,146,8.265041235673205,3.080914602353002,3.0,29.415802631578913
5571236,1525684500,1525684516,16,117,8.443010121327537,6.1,3.0,20.696568145161283
5571237,1525684506,1525684525,19,30,8.880616721222067,4.1211829276135346,4.004756873724723,50.0
5571238,1525684517,1525684561,44,126,7.81507847620572,4.097653485975598,2.0,20.0
5571239,1525684559,1525684598,39,120,23.14631606638609,13.580701411764707,7.0,50.0
5571240,1525684597,1525684606,9,143,15.31799632749554,6.0,5.0,50.0
5571241,1525684602,1525684615,13,129,7.105916419234855,5.0,3.0,14.52440224751265
5571242,1525684615,1525684651,36,140,47.64601475194932,50.0,28.0,54.0
5571243,1525684619,1525684651,32,161,7.50041285980744,6.0,4.0,12.0
5571244,1525684622,1525684651,29,191,6.623785569049821,5.0,4.0,12.464868493150677
5571245,1525684625,1525684652,27,126,4.856202515115605,4.818360922404294,3.0,5.0
5571246,1525684630,1525684653,23,187,6.823464211686924,5.0,2.0,30.0
5571247,1525684640,1525684653,13,212,8.716559159191771,4.0,2.0,50.0
5571248,1525684647,1525684670,23,148,7.653748271463711,5.5,2.0,41.0
5571249,1525684662,1525684678,16,172,11.33749241368331,4.0,2.0,50.0
5571250,1525684674,1525684686,12,176,2.0,2.0,2.0,2.0
5571251,1525684682,1525684695,13,4,2.0,2.0,2.0,2.0
5571252,1525684687,1525684719,32,176,16.25541748782927,6.455497352941175,4.0,50.0
5571253,1525684716,1525684726,10,15,2.0,2.0,2.0,2.0
5571254,1525684723,1525684735,12,88,31.453180179908696,20.0,0.0,91.0
5571255,1525684735,1525684754,19,225,25.74306525713225,20.0,6.1,50.0
5571256,1525684754,1525684789,35,163,15.619153206180599,6.1,5.0,50.0
5571257,1525684790,1525684812,22,168,23.036306189020916,15.670019952918674,4.24,50.0
5571258,1525684811,1525684824,13,73,53.6420619737444,50.0,41.0,90.0
5571259,1525684824,1525684834,10,122,10.638976715910097,6.0,5.0,27.342528793919822
5571260,1525684832,1525684852,20,157,10.794708168789954,6.0,5.0,41.0
5571261,1525684849,1525684868,19,136,13.926468828560127,6.0,4.97471921209011,50.0
5571262,1525684864,1525684869,5,25,2.0,2.0,2.0,2.0
5571263,1525684867,1525684879,12,182,17.9672524549595,11.698706816059019,4.0,55.0
5571264,1525684874,1525684949,75,156,9.507430624126046,6.0,4.0,49.624137563543485
5571265,1525684951,1525684968,17,245,35.19313411920668,25.438324324324338,12.741404943326087,55.470301694899696
5571266,1525684968,1525684998,30,119,33.68211693883844,41.0,15.0,50.0
5571267,1525684995,1525685032,37,0,0,0,0,0
5571268,1525685032,1525685051,19,235,33.037810337837755,24.009134752681703,15.0,52.89517313526516
5571269,1525685049,1525685072,23,221,15.71355452967874,11.27783816146959,6.1,50.0
5571270,1525685072,1525685101,29,172,12.720756035981077,6.0,5.0,50.0
5571271,1525685101,1525685122,21,227,21.777675590050492,15.5,5.1583288528012945,51.597306649648424
5571272,1525685121,1525685161,40,272,15.856076391568912,8.0,5.0,50.0
5571273,1525685163,1525685184,21,163,17.736572757854926,12.0,5.0,50.0
5571274,1525685183,1525685205,22,218,16.75628566798067,20.0,4.110305319999999,50.0
5571275,1525685207,1525685238,31,155,16.341478837801795,10.327900478388155,5.0,50.0
5571276,1525685238,1525685262,24,351,9.017154891396508,1.0,1.0,51.9
5571277,1525685261,1525685270,9,13,104.7538769474899,100.0,83.99020944148936,134.0
5571278,1525685268,1525685295,27,164,18.409040217194587,12.0,6.0,50.0
5571279,1525685294,1525685331,37,133,11.860308908037952,6.0,5.0,50.0
5571280,1525685318,1525685331,13,6,87.01277955271566,91.42631578947369,61.0,111.7936936936937
5571281,1525685323,1525685342,19,0,0,0,0,0
5571282,1525685324,1525685342,18,174,17.03931200006208,10.349889370803282,5.0,50.0
5571283,1525685341,1525685359,18,123,45.589628634062784,50.0,25.98,50.0
5571284,1525685351,1525685395,44,182,8.204046217999233,6.0,4.0,15.0
5571285,1525685397,1525685412,15,194,18.18699399940544,11.96438181958128,4.04332054,52.128180515463896
5571286,1525685411,1525685425,14,26,69.17207728863792,59.895812500000005,49.86540908080334,113.05
5571287,1525685425,1525685434,9,86,25.547932120460462,18.341993762111617,0.0,50.0
5571288,1525685430,1525685481,51,29,34.67219568840914,28.0,20.0,95.46940681284258
5571289,1525685480,1525685500,20,216,16.31410335680833,12.0,6.0,50.0
5571290,1525685498,1525685510,12,278,14.726148085597334,7.855466604370589,6.0,50.0
5571291,1525685507,1525685546,39,160,7.6822468074530805,6.0,5.0,12.956814672966923
5571292,1525685545,1525685556,11,77,25.8027536006451,18.619811677810777,0.0,99.99999917016406
5571293,1525685556,1525685586,30,213,10.701789450936214,6.0,1.0,41.0
5571294,1525685585,1525685595,10,223,21.34844864301575,9.0,5.0,52.14032013574659
5571295,1525685593,1525685606,13,12,19.923652588217173,12.0,12.0,77.98093291703618
5571296,1525685604,1525685616,12,262,6.363986385511403,5.0,1.0,26.175852612508585
5571297,1525685612,1525685625,13,112,11.993870488019652,6.0,5.0,50.0
5571298,1525685615,1525685656,41,70,6.0325571458336595,5.0,4.0,9.619812272727268
5571299,1525685655,1525685666,11,183,15.80679934276741,11.082783303165863,5.3607484163898125,50.0
5571300,1525685662,1525685682,20,130,5.544667539811655,5.0,4.0,8.0
5571301,1525685669,1525685683,14,87,8.063782421007712,5.0,4.0,41.88577004442559
5571302,1525685677,1525685693,16,121,9.918742699059875,6.0,4.0,28.0
5571303,1525685688,1525685702,14,13,45.4002291505416,50.05039696237487,20.0,93.2061041074916
5571304,1525685690,1525685711,21,13,51.69788826807897,50.0,38.73970557210689,91.0
5571305,1525685705,1525685737,32,160,10.623236276522885,7.0,4.0,26.1
5571306,1525685734,1525685753,19,166,14.264251176469415,9.437166755319147,4.0,50.0
5571307,1525685746,1525685776,30,173,12.718291125883933,6.0,1.0,51.06599871432422
5571308,1525685775,1525685791,16,174,11.562934219300885,6.2,4.0,31.411184999999957
5571309,1525685787,1525685807,20,93,8.80825010091316,5.0,4.0,41.0
5571310,1525685805,1525685818,13,207,19.416414648251205,11.969816240763548,5.0,51.9
5571311,1525685814,1525685860,46,52,42.9184731043067,40.8396036036036,26.30276131868132,94.07573120859905
5571312,1525685858,1525685868,10,63,34.90708690022559,21.0,20.0,55.0
5571313,1525685866,1525685878,12,191,10.818023122260014,10.0,5.0,20.814104630128654
5571314,1525685874,1525685887,13,75,8.102963485654255,5.0,4.000000001,21.59186704793582
5571315,1525685878,1525685900,22,124,4.360870423496464,4.0,3.0,5.957251994087489
5571316,1525685897,1525685909,12,182,13.160223156803086,6.1,3.0,60.0
5571317,1525685906,1525685918,12,132,12.237590825981293,6.0,4.0,55.0
5571318,1525685914,1525685968,54,67,9.093004479366792,5.0,3.0,41.0
5571319,1525685931,1525685968,37,134,9.49767791718107,5.0,3.0,33.71134838709678
5571320,1525685969,1525686014,45,146,13.0418395995488,6.1,5.0,50.0
5571321,1525686012,1525686040,28,120,41.83197924871755,31.540236089272724,20.0,91.0
5571322,1525686036,1525686051,15,267,8.160973713192314,1.0,1.0,50.0
5571323,1525686050,1525686076,26,131,9.554789482735275,6.0,5.0,29.979142066420653
5571324,1525686076,1525686094,18,127,11.728114401505414,6.0,4.2100009400500005,50.0
5571325,1525686087,1525686103,16,101,10.245465368702492,5.84087324515867,4.0,26.2
5571326,1525686097,1525686150,53,203,8.180570733598993,4.000000001,1.0,40.42092432432394
5571327,1525686149,1525686164,15,147,38.11211104125496,38.63291527777778,15.0,90.0
5571328,1525686163,1525686172,9,183,12.279310539017123,6.2,5.239209726479378,50.0
5571329,1525686170,1525686208,38,62,5.290520991999683,5.0,4.0,6.125035362385321
5571330,1525686208,1525686228,20,190,17.97637078055703,12.0,6.2,50.0
5571331,1525686222,1525686238,16,84,7.138582848761688,6.0,4.0,14.334167303522392
5571332,1525686233,1525686248,15,161,11.255474805021137,6.0,3.0,50.0
5571333,1525686238,1525686256,18,50,6.452402709466106,5.0,3.0,15.766600953369478
5571334,1525686248,1525686256,8,203,51.68081372180489,55.0,30.0,55.1
5571335,1525686253,1525686274,21,104,9.075730309299582,10.0,4.0,20.0
5571336,1525686271,1525686292,21,73,20.280172751312254,6.2,3.0,50.938688858318784
5571337,1525686280,1525686292,12,138,9.69752750899491,5.0,1.0,48.31037921278599
5571338,1525686288,1525686310,22,60,8.239203741150428,5.856328295454546,3.0,18.9032134185411
5571339,1525686307,1525686362,55,70,20.82688359221312,12.351550810810803,12.0,51.9
5571340,1525686322,1525686364,42,204,21.312844607990364,13.2,6.0,55.010384745972466
5571341,1525686332,1525686374,42,96,7.86736165942758,6.0,4.0,14.919929545454538
5571342,1525686374,1525686394,20,94,6.542953032291454,5.188090324824766,4.0,15.0
5571343,1525686388,1525686403,15,130,13.023718739309677,6.46875,4.368609847641354,50.0
5571344,1525686394,1525686413,19,82,7.816491429907172,5.1658643,4.0,20.021354009077093
5571345,1525686401,1525686441,40,122,26.305110957381533,15.0,12.0,57.99884836267507
5571346,1525686427,1525686442,15,193,8.032846238033827,6.0,4.0,15.0
5571347,1525686433,1525686449,16,22,31.679240264920637,28.022285714285715,10.28423,50.0
5571348,1525686443,1525686460,17,121,9.850753778419001,6.0,4.0,49.30080852714081
5571349,1525686455,1525686476,21,97,7.4383909390070215,5.0,4.0,14.796597811764705
5571350,1525686472,1525686485,13,148,12.78376539472537,6.1,5.454880059692939,50.0
5571351,1525686477,1525686525,48,136,3.7609608663503584,3.0,1.0,8.18489501123595
5571352,1525686525,1525686547,22,202,22.58554016621962,15.13084647766323,5.0,60.0
5571353,1525686535,1525686564,29,158,18.32777777817215,10.282353170731708,5.0,56.0
5571354,1525686563,1525686579,16,239,13.72144359453812,5.324564360423252,1.0,55.274324669744274
5571355,1525686572,1525686588,16,101,25.087761018863613,15.0,7.0,56.0620633214028
5571356,1525686583,1525686596,13,152,15.38802106578089,6.124489167936029,5.0,50.0
5571357,1525686589,1525686605,16,14,7.533847654695339,7.470420053225922,5.0,9.773468259656724
5571358,1525686594,1525686606,12,24,39.32399741488774,28.0,20.0,50.0
5571359,1525686596,1525686627,31,91,6.633398079835578,5.986114590332565,4.24,15.0
5571360,1525686611,1525686636,25,241,7.577097915277538,4.0,1.0,40.0
5571361,1525686624,1525686670,46,98,9.640716839065295,6.0,4.0,27.0
5571362,1525686663,1525686696,33,237,17.122243097988537,12.52385054541384,6.1,41.807152380952324
5571363,1525686695,1525686703,8,215,21.956562155861956,20.0,6.1,50.0
5571364,1525686700,1525686723,23,79,8.07385640887657,6.0,5.0,15.0
5571365,1525686722,1525686730,8,35,57.97957677638716,50.0,22.273933773532352,115.0
5571366,1525686725,1525686738,13,161,11.770952228761239,7.0,4.24,41.0
5571367,1525686730,1525686746,16,156,6.862170531334579,6.0,5.0,12.1753610544
5571368,1525686735,1525686754,19,216,5.638549268015966,4.0,1.0,19.204065671641793
5571369,1525686747,1525686771,24,137,7.856058339169063,5.166893331116944,4.0,18.19730112994349
5571370,1525686763,1525686796,33,185,15.041877717803215,7.0,6.2,50.0
5571371,1525686790,1525686848,58,95,11.54518808332716,6.0,4.0,42.81434999999999
5571372,1525686846,1525686856,10,215,41.8280409731211,50.0,15.0,58.58193494865989
5571373,1525686850,1525686875,25,107,8.276983000867485,7.0,5.5728987095154805,12.172321823999999
5571374,1525686867,1525686885,18,185,18.791891860862695,7.0,6.1,56.13363399999999
5571375,1525686876,1525686885,9,96,9.72389552898002,6.0,5.0,30.670520912001496
5571376,1525686880,1525686895,15,95,6.193985469764485,4.186758539616934,4.0,9.901669924324324
5571377,1525686891,1525686915,24,28,24.384693085992673,20.66142408636192,12.0,50.0
5571378,1525686899,1525686924,25,136,19.217803734098364,12.0,7.0,50.0
5571379,1525686920,1525686935,15,108,6.718682793289849,5.0,4.0,14.313473561886623
5571380,1525686933,1525686944,11,83,26.269865925055292,15.739863651409614,7.0,50.0
5571381,1525686936,1525686954,18,115,4.96386104955303,4.0,3.0,6.0
5571382,1525686948,1525686971,23,179,10.121763737108195,6.0,1.0,50.0
5571383,1525686966,1525686980,14,192,17.894275399367356,6.2,6.1,50.60946787
5571384,1525686977,1525686988,11,97,9.192281512060013,6.0,4.0,23.81527619047598
5571385,1525686989,1525687003,14,55,25.01323466685193,15.0,0.0,54.444359452426156
5571386,1525687000,1525687019,19,128,12.555609931679125,6.0,4.0,50.0
5571387,1525687009,1525687037,28,192,12.071840458230433,4.0,1.0,50.0
5571388,1525687023,1525687045,22,186,18.333936129672722,7.0,6.1,60.0
5571389,1525687035,1525687054,19,169,9.43708386910672,6.46875,6.319403008,24.457497647058815
5571390,1525687039,1525687054,15,167,16.337577120342537,7.625,7.0,58.87448467740051
5571391,1525687046,1525687074,28,227,6.431335184643912,4.90625,1.0,14.424863912515187
5571392,1525687073,1525687091,18,176,12.046290596557215,6.0,3.04265455,50.0
5571393,1525687088,1525687113,25,161,22.902305549211675,8.315830232966617,7.0,58.0
5571394,1525687101,1525687162,61,161,8.601308293511563,7.0,6.0,12.092193011273775
5571395,1525687160,1525687170,10,156,41.93033471494056,50.0,20.0,54.0
5571396,1525687162,1525687202,40,169,8.111474685424692,7.0,5.0,14.0
5571397,1525687201,1525687218,17,301,19.515424704919987,11.439199444077593,1.0,51.445188973842406
5571398,1525687217,1525687231,14,148,15.451007785535076,7.716031454545455,5.443268392053264,50.0
5571399,1525687231,1525687240,9,164,24.510864911972362,21.531425364498958,7.0,50.0
5571400,1525687237,1525687252,15,130,10.680972686986964,6.0,5.0,30.553475999999993
5571401,1525687251,1525687261,10,48,8.886846321050244,5.352641018971242,4.90625,33.53631578947353
5571402,1525687255,1525687278,23,166,9.768397618851882,7.0,7.0,18.833439410865473
5571403,1525687271,1525687297,26,171,15.141479747318568,7.0,7.0,50.0
5571404,1525687287,1525687309,22,125,20.533480433824927,12.0,7.0,50.97720827562099
5571405,1525687307,1525687319,12,159,10.463053703747505,6.350749038461538,5.0,27.0
5571406,1525687313,1525687345,32,166,8.586835480924645,7.0,7.0,15.0
5571407,1525687336,1525687356,20,145,13.713820415348799,7.0,5.320747674999211,50.0
5571408,1525687343,1525687358,15,122,8.707770863266031,5.0,4.0,28.807038738738694
5571409,1525687355,1525687377,22,87,11.802415585169536,6.0,4.0,48.712371752201065
5571410,1525687366,1525687387,21,99,33.0003989862652,25.853571428571392,10.0,58.0
5571411,1525687375,1525687397,22,36,6.124741412784405,6.0,5.0,7.132241328413284
5571412,1525687395,1525687415,20,176,13.352533872964832,9.898771590157144,4.1979499832250005,44.0438367241996
5571413,1525687407,1525687431,24,175,14.405966453000758,12.0,7.0,50.0
5571414,1525687428,1525687441,13,131,16.23025737349699,10.350354727413348,5.0,52.539406060606034
5571415,1525687435,1525687467,32,103,6.868834430500733,6.185646095996461,6.0,8.511022372881333
5571416,1525687465,1525687491,26,89,54.16819237902504,50.0,41.0,91.0
5571417,1525687489,1525687501,12,72,28.59101675222913,23.0,20.0,50.0
5571418,1525687492,1525687510,18,107,12.928924335278607,12.0,9.466267713685307,16.21897002538429
5571419,1525687500,1525687535,35,157,8.277414179090236,7.0,7.0,12.661570786499892
5571420,1525687526,1525687548,22,279,13.865495488456816,1.0,1.0,50.0
5571421,1525687531,1525687564,33,192,12.867649780179903,7.0,6.0,27.0
5571422,1525687548,1525687564,16,175,12.662066544323876,7.0,7.0,50.0
5571423,1525687559,1525687591,32,143,13.069212747075802,7.0,7.0,50.0
5571424,1525687582,1525687599,17,177,11.246282995668645,7.0,6.0,30.0
5571425,1525687587,1525687607,20,97,8.527030094049328,5.0,1.0,27.0
5571426,1525687595,1525687618,23,172,6.986746950076387,4.744313524768852,1.0,15.0
5571427,1525687615,1525687673,58,183,23.921153030354,15.0,7.0,58.8772266
5571428,1525687650,1525687673,23,88,41.71713349844293,41.0,20.0,91.0
5571429,1525687670,1525687682,12,191,12.185801239061878,7.0,6.0,41.0
5571430,1525687677,1525687693,16,82,7.019494384563477,5.0,4.0,7.0
5571431,1525687692,1525687705,13,181,10.219259696646684,4.0,3.038212014122359,28.0
5571432,1525687700,1525687715,15,51,51.90891602083918,50.0,41.0,70.0
5571433,1525687712,1525687725,13,168,10.655386011303648,8.431438859769273,4.0,25.201019753086396
5571434,1525687719,1525687737,18,126,7.513807188420469,6.0,1.0,20.41159387755101
5571435,1525687724,1525687737,13,95,4.568510945256965,3.0,3.0,11.929315626262191
5571436,1525687727,1525687751,24,155,11.145801105861105,7.0,7.0,30.0
5571437,1525687751,1525687765,14,191,12.185422252748367,8.073777405814475,1.0,50.0
5571438,1525687765,1525687782,17,35,27.699859635406106,14.10395973185412,12.0,90.23012613175997
5571439,1525687779,1525687791,12,188,13.670345846184217,8.734241028818097,1.0,51.9
5571440,1525687787,1525687822,35,84,8.455993295474894,6.0,3.0064615874141922,28.619568128219942
5571441,1525687816,1525687850,34,189,13.71302408598349,8.0,4.0,50.11781850451627
5571442,1525687842,1525687872,30,167,13.671065398202876,8.00358396923077,1.0,51.37623649691357
5571443,1525687865,1525687891,26,155,32.138288841639465,20.0,7.0,91.0
5571444,1525687880,1525687917,37,163,11.591933064977981,8.080492935064935,7.0,36.5393691253468
5571445,1525687887,1525687917,30,171,8.625422710159155,7.0,5.0,19.91579587825696
5571446,1525687893,1525687953,60,175,8.263063998300783,7.0,5.0,15.30665051119172
5571447,1525687948,1525687963,15,156,25.284842711252804,17.138410926365793,8.0,56.82758895027606
5571448,1525687952,1525687971,19,101,6.403094318825779,6.0,5.0,11.311847586837876
5571449,1525687969,1525687983,14,132,9.457681811647255,6.024681297583582,5.0,25.0
5571450,1525687973,1525688005,32,171,10.202162511055487,6.0,4.0,50.0
5571451,1525687996,1525688024,28,238,12.962547355758822,7.0,4.0,50.0
5571452,1525688024,1525688069,45,154,17.772337227778472,8.811675631736346,7.0,50.0
5571453,1525688061,1525688079,18,253,13.99998416863459,7.0,1.0,50.0
5571454,1525688069,1525688090,21,75,8.00345451925484,6.0,4.125,13.071346669008564
5571455,1525688074,1525688101,27,308,21.55748419518808,20.0,20.0,44.28314372902222
5571456,1525688079,1525688101,22,168,7.505772806546509,5.789793605115339,3.0,20.0
5571457,1525688089,1525688102,13,358,20.73965731073885,20.0,20.0,20.0
5571458,1525688095,1525688111,16,236,18.39666404265604,20.0,7.0,20.0
5571459,1525688111,1525688133,22,118,20.981302870599254,20.0,20.0,20.0
5571460,1525688115,1525688141,26,169,9.873133965390066,7.0,4.0,42.72485204722837
5571461,1525688133,1525688162,29,216,9.27039731338353,6.096617171950937,4.0,41.0
5571462,1525688158,1525688192,34,351,13.109947129426892,1.0,1.0,50.333772144654944
5571463,1525688181,1525688208,27,161,21.2139026995863,13.296622318139896,7.0,51.80110784569909
5571464,1525688186,1525688209,23,107,8.02374643022983,6.0,5.0,31.243658393434444
5571465,1525688193,1525688218,25,101,10.261854480523608,4.0,2.6773182844246604,50.0
5571466,1525688204,1525688218,14,154,6.975161466787125,5.164015115712545,2.1,16.08677012096772
5571467,1525688212,1525688237,25,174,15.849914465138017,9.496944318181816,7.0,50.0
5571468,1525688221,1525688247,26,159,7.370778937248411,5.053605664488018,1.0,28.0
5571469,1525688237,1525688272,35,166,10.487795066821596,7.0,2.0,41.0
5571470,1525688271,1525688294,23,190,19.044398769099885,12.0,6.2,50.0
5571471,1525688278,1525688306,28,123,18.395756524129222,9.0,7.0,50.0
5571472,1525688298,1525688315,17,156,15.373356143246848,8.270032763636364,7.0,50.0
5571473,1525688300,1525688316,16,179,6.860699108507449,7.0,4.125,7.250969662199198
5571474,1525688309,1525688329,20,228,8.375950054557526,7.0,4.0,14.005547762792542
5571475,1525688327,1525688338,11,163,10.824693232865354,7.0,3.0,50.0
5571476,1525688332,1525688356,24,132,7.950726091197356,6.1388990048599865,4.0,17.817258878504646
5571477,1525688356,1525688372,16,206,13.730707705492788,8.057516087565993,4.0,50.0
5571478,1525688367,1525688400,33,76,23.840617635281,14.584877791092762,12.0,50.0
5571479,1525688399,1525688410,11,157,9.844861986073639,7.0,4.0,23.454676954259895
5571480,1525688408,1525688420,12,201,19.132535107984495,8.328863878016,4.0,50.19464369109576
5571481,1525688415,1525688430,15,102,10.766447664840308,7.0,4.0,50.0
5571482,1525688424,1525688441,17,245,7.965471238081941,1.0,1.0,50.0
5571483,1525688436,1525688450,14,181,16.460086017726862,8.11,4.0,50.0
5571484,1525688442,1525688468,26,157,8.270668950972148,7.0,4.0,15.11584191176467
5571485,1525688447,1525688478,31,203,8.340909388066123,6.0,3.0,20.31463174603173
5571486,1525688477,1525688508,31,192,12.690180516037902,8.684290286424421,2.3744512143020833,42.17093402777774
5571487,1525688501,1525688542,41,116,10.23139368253953,5.0,4.0,50.0
5571488,1525688537,1525688591,54,201,17.858359206265316,12.0,4.0,50.0
5571489,1525688591,1525688610,19,205,20.327725142228633,10.000000000574397,6.0,50.69029359584934
5571490,1525688604,1525688619,15,191,11.085302707851639,7.0,4.0,20.0
5571491,1525688610,1525688647,37,101,6.963349251222721,6.0,4.0,12.207125126231526
5571492,1525688646,1525688655,9,155,17.861985365332007,10.0,7.0,50.50200947163259
5571493,1525688654,1525688672,18,107,9.290373629042007,7.0,4.0,20.0
5571494,1525688666,1525688673,7,88,7.222872023079613,5.0,3.4948162471719457,19.052821513902792
5571495,1525688670,1525688682,12,80,4.152825185495029,4.0,2.0,6.544757573033706
5571496,1525688677,1525688698,21,178,9.401273765264936,5.0,4.0,50.0
5571497,1525688679,1525688716,37,199,6.163610525429303,4.0,2.0,19.182540298507448
5571498,1525688708,1525688716,8,205,12.318588063541565,7.0,4.0,60.0
5571499,1525688713,1525688738,25,86,7.20761713268131,5.0,2.0,20.10708380035601
5571500,1525688730,1525688738,8,214,41.90362000680806,58.0,6.0,78.52396999999999
5571501,1525688740,1525688750,10,119,7.735945897481448,8.11,4.0,13.46404302901655
5571502,1525688748,1525688758,10,180,44.17322974548485,58.0,6.0,80.50780999999998
5571503,1525688753,1525688765,12,109,14.031902442939893,6.0,4.0,60.58544588877855
5571504,1525688757,1525688780,23,149,5.275415722771025,5.0,4.0,10.165583817279028
5571505,1525688763,1525688789,26,49,58.84005007859891,50.0,41.0,100.0
5571506,1525688782,1525688829,47,181,12.08874979718004,7.0,4.8,50.0
5571507,1525688799,1525688829,30,91,9.560490236116385,5.0,4.0,30.416423333333334
5571508,1525688808,1525688829,21,132,7.852926107951355,6.0,3.0,15.0
5571509,1525688827,1525688838,11,18,4.589217565538889,0.0,0.0,25.00380638856022
5571510,1525688831,1525688873,42,165,14.631427995556171,8.068203980952381,5.0,50.0
5571511,1525688865,1525688880,15,95,8.40098174934249,7.0,4.0,18.44078943272782
5571512,1525688871,1525688881,10,112,12.117718387898563,7.0,4.0,50.0
5571513,1525688878,1525688896,18,15,9.1197300087569,8.110412356053915,7.015138707233935,15.0
5571514,1525688887,1525688904,17,23,15.462073282971765,5.1982596774193555,0.0,50.0
5571515,1525688897,1525688934,37,154,11.946395508670475,7.6038034375,4.0,50.0
5571516,1525688932,1525688949,17,292,9.85008254209246,1.0,1.0,50.0
5571517,1525688942,1525688960,18,183,9.121091261057252,7.0,4.0,20.664479000984933
5571518,1525688958,1525688976,18,68,11.29327940445025,8.16744773125,4.0,27.0
5571519,1525688966,1525688986,20,56,33.13884662021244,46.82122386466481,0.0,58.0
5571520,1525688985,1525688997,12,126,7.764141212430933,7.0,4.0,11.0
5571521,1525688994,1525689006,12,190,34.99003778640499,44.77261192893938,4.0,60.684971254277635
5571522,1525689000,1525689018,18,80,7.09163125199139,6.932583568618375,3.0,14.87203105882352
5571523,1525689017,1525689043,26,111,16.316780782063226,10.0,3.0,50.4820528
5571524,1525689042,1525689061,19,83,40.17163948252833,50.0,12.0,73.94201124075444
5571525,1525689061,1525689090,29,90,8.339733000526518,3.0,3.0,27.432579279279267
5571526,1525689089,1525689097,8,16,20.806066360347774,2.0,2.0,99.53679400380588
5571527,1525689097,1525689106,9,159,33.32042063418856,28.0,7.0,60.799447344145214
5571528,1525689102,1525689120,18,198,6.827775305062682,7.0,1.0,11.510608156626503
5571529,1525689110,1525689128,18,76,8.316112422204732,6.2,3.997255208791209,20.99358434213452
5571530,1525689115,1525689128,13,82,6.291974276256597,3.0,3.0,18.10441980198015
5571531,1525689125,1525689155,30,190,9.040624641568275,6.060581488673139,2.0,30.0
5571532,1525689153,1525689166,13,201,9.603250624136054,7.0,2.0,44.65069019870054
5571533,1525689164,1525689176,12,184,8.336221780154096,7.0,2.0,19.952809756097547
5571534,1525689173,1525689193,20,182,10.354972725226023,7.0,4.11,33.1389915599879
5571535,1525689188,1525689203,15,136,12.60790404281787,7.0,3.0,48.518771539701675
5571536,1525689201,1525689211,10,196,6.283047613587694,6.248264641561124,2.0,20.0
5571537,1525689207,1525689222,15,162,7.946533146729484,6.278198278715657,2.0,20.0
5571538,1525689220,1525689230,10,215,10.25947296381055,5.014256233108108,2.0,42.323808426863124
5571539,1525689224,1525689237,13,94,7.799627940635489,6.0,1.0,11.05348444444442
5571540,1525689235,1525689245,10,41,18.104091980745995,10.0,5.15037866151734,51.30817848147814
5571541,1525689240,1525689252,12,118,7.686948415542049,6.0,3.0,15.195216606990286
5571542,1525689247,1525689277,30,173,5.9876139470800585,3.0,2.0,27.881085869565204
5571543,1525689276,1525689285,9,233,16.975156895494397,9.64684206432156,1.0,51.9
5571544,1525689277,1525689323,46,106,6.294004986878146,6.0,2.0,20.389023942051942
5571545,1525689321,1525689349,28,215,22.695890421597927,20.0,1.0,51.87857579999999
5571546,1525689336,1525689364,28,193,15.615559095899835,8.04,5.0,50.0
5571547,1525689358,1525689406,48,231,10.835370576422397,4.0,1.0,51.9
5571548,1525689403,1525689422,19,130,18.716770521445575,12.232936430317848,8.0,50.38916524072902
5571549,1525689414,1525689434,20,59,46.8563990264885,34.055699597675456,20.0,115.0
5571550,1525689434,1525689443,9,150,10.14776814400058,7.0,4.0,41.0
5571551,1525689437,1525689457,20,15,36.98142713316146,41.0,12.0,68.44657673991459
5571552,1525689448,1525689467,19,135,10.03301465594813,6.682195881796942,3.0,28.0
5571553,1525689463,1525689484,21,175,9.200204136523904,6.0,3.0,27.331937966714918
5571554,1525689476,1525689503,27,228,22.557166536967443,10.0,9.0,50.0
5571555,1525689485,1525689511,26,26,32.81025251346066,24.288015547844424,20.250612121702734,58.76737620719972
5571556,1525689509,1525689520,11,170,14.390539579313382,10.0,7.0,50.0
5571557,1525689517,1525689538,21,147,7.001627749352922,6.0,3.0,9.929955761668321
5571558,1525689537,1525689572,35,43,19.8784902726124,20.0,0.0,57.58670309496179
5571559,1525689566,1525689573,7,158,10.83838358499009,7.0,3.0,41.0
5571560,1525689569,1525689625,56,53,8.125974419592593,5.932762471835846,3.0,13.89755348465293
5571561,1525689623,1525689634,11,214,18.292731812881378,12.0,6.1619797740113,50.0
5571562,1525689635,1525689643,8,195,12.511113334014247,8.069476507692308,5.0,50.0
5571563,1525689640,1525689650,10,111,6.094322664124826,4.11,3.0,13.364813897307386
5571564,1525689644,1525689658,14,68,6.539196267958389,6.0,2.0,9.836990748437499
5571565,1525689655,1525689679,24,118,7.9946971743193105,5.7689682112068965,2.0,15.036189504379712
5571566,1525689675,1525689695,20,158,16.806933586549466,8.118031360476662,6.881342709976941,58.0
5571567,1525689692,1525689703,11,81,11.252370317415767,7.005768349514563,4.11,22.865262003232026
5571568,1525689697,1525689733,36,197,7.594304045817556,5.334349826787413,4.0,20.0
5571569,1525689731,1525689758,27,186,11.440192614817779,7.204270967741933,3.0,40.0
5571570,1525689757,1525689807,50,170,14.862963248836001,7.0,3.0,50.0
5571571,1525689801,1525689828,27,213,27.092428442457802,20.0,7.0,50.0
5571572,1525689825,1525689837,12,163,10.75821769201589,7.0,4.0,48.41728605889902
5571573,1525689836,1525689847,11,172,10.122878912347137,6.616758867347898,2.0,20.0
5571574,1525689843,1525689859,16,156,10.827091679278224,8.11,4.0,50.0
5571575,1525689848,1525689859,11,82,8.662728860109398,5.887160765481651,3.509484430182761,43.964373020186365
5571576,1525689853,1525689860,7,13,6.101740842423277,5.189972192527993,4.03220158819074,15.411036958157895
5571577,1525689856,1525689868,12,87,7.9832214019191685,3.8220111111111095,3.0,23.568010185185145
5571578,1525689864,1525689885,21,47,15.237721389121372,8.128112177365983,5.81182390409692,38.11533975474093
5571579,1525689869,1525689895,26,160,6.271098157054636,2.081172779394223,2.0,28.0
5571580,1525689875,1525689895,20,22,7.488686989213055,8.060105683206952,5.4,9.506578306852035
5571581,1525689880,1525689922,42,185,4.640185938857329,4.0,2.0,16.615675276752732
5571582,1525689920,1525689963,43,173,14.552458163311385,9.070562734375002,4.0,50.0
5571583,1525689964,1525689973,9,78,23.842035368280488,20.0,0.0,64.8937757851811
5571584,1525689969,1525690023,54,161,14.954243053544507,8.0,5.0,50.0
5571585,1525690022,1525690033,11,217,32.2545817356553,27.0,9.0,60.0
5571586,1525690027,1525690065,38,159,10.508535802509739,7.0,4.0,26.397080995475108
5571587,1525690066,1525690087,21,148,19.260229213394574,8.250455743131413,6.0,57.704591610926684
5571588,1525690086,1525690117,31,107,9.869716470782315,5.992522752808989,2.0,30.0
5571589,1525690116,1525690127,11,175,17.415998939057957,9.089307216494843,4.0,41.0
5571590,1525690123,1525690142,19,140,6.995396556950108,4.149209999999996,3.0,20.0
5571591,1525690135,1525690158,23,142,9.043490874704313,6.0,2.0,50.0
5571592,1525690146,1525690166,20,195,13.284260658275636,8.11,3.0,50.0
5571593,1525690153,1525690166,13,147,14.604041753890709,7.0,4.0,55.07309545336317
5571594,1525690162,1525690176,14,210,13.373928429088028,10.0,5.392180032008291,50.0
5571595,1525690173,1525690193,20,156,7.490149869434233,5.899585661597797,2.0,13.650156941176471
5571596,1525690191,1525690204,13,159,21.10660805928518,8.495534310679611,6.0,50.0
5571597,1525690203,1525690222,19,218,5.917556949350831,3.0,2.0,14.001075
5571598,1525690212,1525690231,19,179,7.703927456491689,6.0,2.0,20.466554875283443
5571599,1525690228,1525690239,11,64,42.59577458788808,50.0,27.0,53.021352828962094
5571600,1525690232,1525690258,26,227,4.22106521289828,3.0,2.0,4.0
5571601,1525690252,1525690280,28,303,9.6386101281391,1.0,1.0,46.6705165170636
5571602,1525690277,1525690305,28,193,12.904261704705258,7.0,4.0,48.68179458959435
5571603,1525690305,1525690315,10,229,32.65322556886193,28.0,7.6,60.52207825661117
5571604,1525690310,1525690334,24,144,5.638737726153807,6.0,1.0,9.083182958252426
5571605,1525690319,1525690334,15,166,9.631846319635752,3.8,2.0,36.80695304737138
5571606,1525690330,1525690369,39,188,9.429523135326669,6.0,4.081753886987498,30.446146758620667
5571607,1525690333,1525690370,37,114,4.1718622782877635,3.0,2.0,11.766447953216371
5571608,1525690336,1525690370,34,121,4.649888410695998,6.0,1.0,9.652295054617676
5571609,1525690347,1525690370,23,193,6.21105279165723,3.0,2.0,17.157142648051874
5571610,1525690366,1525690403,37,171,15.33837577982709,8.653202110604257,2.2,52.950835553181385
5571611,1525690388,1525690403,15,212,7.554236472415561,5.798996487958716,2.0,27.0
5571612,1525690393,1525690450,57,141,6.61869536742377,6.0,2.0,11.70294816911104
5571613,1525690398,1525690452,54,190,4.673925854780435,2.0,2.0,9.615983912037036
5571614,1525690413,1525690452,39,83,13.136518719693433,7.0,1.0,50.0
5571615,1525690430,1525690452,22,57,26.387064480114194,15.0,12.0,52.407101649484524
5571616,1525690435,1525690465,30,150,11.688994229255393,7.9631405452876685,3.4376699540425677,35.27307475113109
5571617,1525690455,1525690466,11,111,8.63256224136377,6.0,3.8,13.90543496120368
5571618,1525690460,1525690478,18,141,5.63570854358018,3.0,2.0,20.0
5571619,1525690473,1525690487,14,195,6.8494594785489,5.1775487155750985,2.0,20.0
5571620,1525690485,1525690504,19,111,12.282800383170985,8.11,1.0,50.0
5571621,1525690499,1525690560,61,167,10.740234406812627,4.0,2.0,50.0
5571622,1525690554,1525690568,14,221,37.912929132574256,41.47337951509154,9.0,91.0
5571623,1525690559,1525690570,11,145,7.399560208506457,6.0,3.0,14.003456584688104
5571624,1525690565,1525690596,31,100,11.05698893968238,5.847402672872729,3.0,40.32189523809523
5571625,1525690587,1525690604,17,195,19.331344292936567,10.030714521841794,1.0,54.0
5571626,1525690596,1525690612,16,79,9.103300960137059,6.0,3.0,40.2328676253511
5571627,1525690603,1525690620,17,127,3.849764702721168,3.0,2.0,9.548809735394125
5571628,1525690614,1525690620,6,132,8.863639334695414,6.0,2.1538851005202915,20.532485714285702
5571629,1525690617,1525690642,25,89,7.367172160907221,3.0,2.2,32.910493333333264
5571630,1525690642,1525690665,23,183,14.048304477762004,8.304699635882157,1.0,50.0
5571631,1525690658,1525690673,15,59,45.377181286944385,50.0,20.0,80.0
5571632,1525690671,1525690688,17,178,10.373555908400812,8.095837867647058,4.0,30.0
5571633,1525690686,1525690697,11,121,11.096343676717677,6.0,3.0,49.00349958828368
5571634,1525690690,1525690704,14,41,10.802014207824103,8.11,1.0187345454545451,20.0
5571635,1525690696,1525690725,29,62,10.394096320840967,6.0,4.0,30.0
5571636,1525690716,1525690750,34,153,21.636114542970287,8.11,4.0,61.44421428571379
5571637,1525690740,1525690776,36,127,11.504356254314816,7.0,5.6875,40.99607804861493
5571638,1525690775,1525690823,48,142,13.5722239092543,6.9112,5.0,50.230400514285684
5571639,1525690822,1525690835,13,365,1.1939313984168864,1.0,1.0,1.0
5571640,1525690835,1525690846,11,234,19.669040918176968,10.0,6.2,51.11004258766195
5571641,1525690842,1525690863,21,133,13.657871115492012,9.0,4.195336163702822,50.0
5571642,1525690856,1525690864,8,48,14.725382332942239,10.0,3.9227845714285716,41.60353096556552
5571643,1525690862,1525690914,52,82,5.929436191289282,5.943758074132962,3.0,8.109073409896906
5571644,1525690913,1525690922,9,219,22.691616255313445,15.012781372870249,6.093734705882353,50.4943839097541
5571645,1525690918,1525690943,25,96,12.268561540583669,8.11,4.0,50.0
5571646,1525690939,1525690965,26,97,10.223516023229621,6.0,3.0,35.2096193665158
5571647,1525690963,1525690973,10,153,12.142305568863954,7.0,3.0,49.97872156595448
5571648,1525690966,1525690982,16,78,8.42778539365688,6.0,3.0,23.08405098039208
5571649,1525690981,1525690999,18,96,9.633160903301246,5.0,2.5625,50.0
5571650,1525690985,1525691000,15,130,4.520901048153295,3.0,2.0,7.0
5571651,1525690996,1525691019,23,108,10.353656464607862,6.0,2.709740038095238,50.0
5571652,1525691018,1525691060,42,191,20.399179806289993,9.0,6.0,57.52
5571653,1525691060,1525691069,9,191,18.010829605567555,8.394033101621979,4.0,57.346490512976416
5571654,1525691065,1525691085,20,147,13.889895940372181,6.0,3.0,50.0
5571655,1525691083,1525691108,25,110,12.924163515899455,5.0,2.0,50.0
5571656,1525691109,1525691126,17,165,19.40785157771975,12.234151242761673,5.0,50.0
5571657,1525691125,1525691145,20,76,12.046195922726096,6.0,3.0,54.38162653477009
5571658,1525691144,1525691153,9,100,16.16591352322324,7.0,4.0,52.254527834365554
5571659,1525691151,1525691163,12,215,4.730961635236831,3.0,1.0,17.417774524028896
5571660,1525691162,1525691178,16,172,8.584988851997835,6.002857989343165,2.0,24.770009348958325
5571661,1525691178,1525691187,9,118,10.182943700020878,6.527590787499999,4.0,30.0
5571662,1525691186,1525691206,20,81,8.106475319728002,5.0,2.0,19.7520094117647
5571663,1525691199,1525691207,8,220,19.011990953375744,13.079038235294112,5.0,50.0
5571664,1525691203,1525691227,24,122,9.539862306684173,5.827496412867392,3.687340845070426,48.13025257142855
5571665,1525691226,1525691259,33,188,10.736707450431645,6.46875,2.0,50.0
5571666,1525691258,1525691276,18,185,19.07283133169261,7.7,4.0,52.43941309799541
5571667,1525691275,1525691287,12,279,8.647633519935587,4.0,1.0,41.0
5571668,1525691282,1525691313,31,85,9.13933405619512,6.654653593464352,3.1,28.0
5571669,1525691312,1525691322,10,200,24.85528214898472,10.0,3.0,80.0
5571670,1525691319,1525691336,17,48,4.204106902621062,2.352300867724868,2.0,10.879322857142844
5571671,1525691335,1525691349,14,187,14.105318265047167,6.2,1.0,50.0
5571672,1525691348,1525691358,10,175,6.07701159087749,2.0,2.0,20.0
5571673,1525691354,1525691369,15,98,39.27858139968915,50.0,12.0,61.93192366412212
5571674,1525691368,1525691379,11,174,4.640293326287882,3.0,2.0,10.0
5571675,1525691376,1525691381,5,166,4.799860568745856,3.0,2.0,18.66017369614512
5571676,1525691379,1525691399,20,133,3.9125010651710306,2.2,2.0,6.0
5571677,1525691395,1525691413,18,100,10.023003253481221,6.0903765563526955,3.0,30.0
5571678,1525691412,1525691422,10,149,8.416310722098592,3.0,2.0,41.0
5571679,1525691416,1525691435,19,203,5.363401539396873,2.0,1.78125,19.8
5571680,1525691435,1525691443,8,218,20.12167062759906,10.515899796070627,1.0,90.0
5571681,1525691440,1525691454,14,82,7.2549444603847695,5.191483116178117,2.0,16.793136266308757
5571682,1525691452,1525691462,10,75,2.8165187134661043,2.0,1.78125,5.165804625047567
5571683,1525691457,1525691471,14,114,8.947186220298557,7.826200363526204,2.0,20.220837859311487
5571684,1525691461,1525691492,31,133,12.790767247876955,6.0,2.2,50.0
5571685,1525691482,1525691492,10,193,10.805193315971106,5.0,2.0,50.0
5571686,1525691486,1525691502,16,15,8.210608708470089,7.834629516475192,2.0,46.124666782608685
5571687,1525691492,1525691520,28,142,7.630601494594744,4.0,2.0,37.6403872045259
5571688,1525691517,1525691529,12,177,10.266366145541026,5.0,1.8335573615630447,30.0
5571689,1525691531,1525691545,14,200,17.928343921684192,6.858467611336029,1.0295218309859158,50.0
5571690,1525691542,1525691561,19,99,8.536273019756283,5.075974326396495,2.0,20.0
5571691,1525691561,1525691578,17,190,9.143929124882371,4.0,2.0,41.30600220940199
5571692,1525691575,1525691625,50,238,5.97270219265676,4.0,1.5,20.0
5571693,1525691626,1525691635,9,152,27.330226632208177,20.0,12.0,80.0
5571694,1525691631,1525691663,32,299,4.202384359174006,1.5,1.0,9.742430249999995
5571695,1525691662,1525691671,9,228,13.570129859254642,10.0,1.0,50.0
5571696,1525691667,1525691679,12,206,6.653092275098995,3.0,2.0,20.991358923076923
5571697,1525691673,1525691688,15,270,4.799534139481008,3.0,1.0,6.832274181818179
5571698,1525691681,1525691714,33,120,9.829482191030717,5.0,1.5,36.089837293114876
5571699,1525691712,1525691725,13,188,11.076107361269534,6.0,2.0,46.54426903648632
5571700,1525691723,1525691744,21,242,7.363073940573085,2.0,1.2100182599573441,40.779363843078244
5571701,1525691736,1525691753,17,235,5.257425999289905,2.0,1.0,20.0
5571702,1525691748,1525691762,14,55,26.235279090040848,19.21194557823129,12.0,50.0
5571703,1525691761,1525691770,9,187,7.409992318792909,5.0,1.0,34.666846410136294
5571704,1525691770,1525691798,28,106,13.547069178930341,6.288706373626374,1.0,50.0
5571705,1525691797,1525691818,21,193,18.696313807599353,10.0,1.0,60.0
5571706,1525691811,1525691818,7,78,8.675987211846017,5.946608614950241,4.0,26.740285405405373
5571707,1525691815,1525691841,26,182,6.99340183772338,3.0,1.5,30.0
5571708,1525691839,1525691849,10,201,12.90196501860656,6.0,2.0,50.0
5571709,1525691847,1525691892,45,143,18.377292253148052,7.1933875,4.0,50.0
5571710,1525691888,1525691901,13,211,20.27977959774461,12.0,4.0,50.0
5571711,1525691892,1525691909,17,28,7.770091302239663,6.0,4.0,20.701593641618494
5571712,1525691903,1525691944,41,94,8.869801617271149,5.0,3.0,25.40489749999997
5571713,1525691943,1525691952,9,181,14.098264306891725,10.0,4.0,50.0
5571714,1525691946,1525691962,16,162,3.160032300294263,2.0,2.0,5.0
5571715,1525691951,1525691970,19,96,8.336093010890545,5.0,1.5,22.831631535269675
5571716,1525691963,1525692000,37,234,14.883726820978687,3.0,1.5,21.423319135766416
5571717,1525691994,1525692008,14,162,13.0890111792232,6.0,3.0,50.478799990231565
5571718,1525692002,1525692051,49,138,15.464871043742649,6.0,4.0,50.0
5571719,1525692050,1525692066,16,213,23.665269215813318,21.0,5.387676679667679,50.02246261622954
5571720,1525692057,1525692074,17,149,6.508691722037909,5.0,4.0,15.159060134294947
5571721,1525692060,1525692074,14,100,5.403051787961141,4.0,2.2,20.0
5571722,1525692069,1525692086,17,164,5.447684835815895,2.097999138509615,2.0,8.90321855932202
5571723,1525692087,1525692107,20,219,10.676875317570902,6.0,4.0,30.913109999999776
5571724,1525692093,1525692131,38,76,28.82657214274253,24.356571428571392,0.0,76.1494035087719
5571725,1525692131,1525692158,27,147,10.677506917409087,6.0,4.0,30.0
5571726,1525692155,1525692189,34,203,11.585124892864437,2.0,1.0,50.0
5571727,1525692189,1525692249,60,203,22.854016967039765,15.357048392530418,5.02,60.0
5571728,1525692248,1525692258,10,178,22.222195646803513,10.0,5.0,69.43800550458714
5571729,1525692257,1525692274,17,138,10.599511520415787,5.5346261829653,1.0,30.227555234512884
5571730,1525692266,1525692274,8,271,1.6349921069190774,1.120588735632184,1.0,2.0
5571731,1525692278,1525692303,25,140,9.813486865551836,6.0,4.0,30.913299117647043
5571732,1525692299,1525692311,12,110,10.915984663742869,5.0,3.0,40.24897440477885
5571733,1525692306,1525692331,25,109,8.020354314861715,5.0,2.0,30.0
5571734,1525692323,1525692331,8,125,13.416353748395158,7.0,4.0,50.0
5571735,1525692327,1525692339,12,12,6.295025131332497,5.726063519370945,0.25,10.234827296408099
5571736,1525692332,1525692381,49,177,5.218408538568703,3.0,2.2,15.079206298828101
5571737,1525692380,1525692416,36,231,11.438252328837828,5.02,4.0,50.0
5571738,1525692415,1525692425,10,204,20.853575670642364,20.0,4.0,50.0
5571739,1525692420,1525692473,53,98,10.056049374756657,5.0,4.0,41.76166976744185
5571740,1525692471,1525692482,11,183,26.67651563752846,20.0,5.5,57.55
5571741,1525692482,1525692491,9,276,6.357334158078215,5.0,1.0,20.876842490566034
5571742,1525692484,1525692500,16,143,6.426980264126618,4.0,2.0,14.247753374083128
5571743,1525692497,1525692508,11,136,4.431732880965271,2.0,2.0,20.0
5571744,1525692499,1525692508,9,59,7.483146406392536,5.392408235294118,2.0,21.164934629186256
5571745,1525692504,1525692516,12,131,6.458612000733986,2.2,2.0,21.657868888888878
5571746,1525692511,1525692534,23,20,49.607530133501776,50.0,20.0,98.35613313771543
5571747,1525692525,1525692557,32,184,6.509371537886293,5.0,2.0,20.0
5571748,1525692552,1525692565,13,211,10.654984921035982,5.5,3.0,38.54388615384614
5571749,1525692561,1525692575,14,111,11.353511785589662,5.6106495412844035,4.0,50.0
5571750,1525692571,1525692585,14,99,7.2418866631823064,4.0,2.0,38.377482735046094
5571751,1525692579,1525692599,20,37,55.72146527116806,50.0,40.232843485,134.0
5571752,1525692594,1525692608,14,193,8.976187877381214,7.0,3.0,20.0
5571753,1525692607,1525692623,16,203,21.166633663407854,8.0,4.0,50.0
5571754,1525692628,1525692651,23,145,12.30691878997189,7.0,4.0,41.0
5571755,1525692651,1525692659,8,107,9.818433194528975,6.0,4.0,30.0
5571756,1525692654,1525692660,6,92,8.881800863431193,4.0,2.0,41.0
5571757,1525692660,1525692677,17,174,16.460116958858766,7.0,4.0,50.0
5571758,1525692664,1525692678,14,176,2.2272398768373027,2.0,2.0,3.5696040265650213
5571759,1525692671,1525692701,30,203,9.89893645814069,7.0,4.0,41.0
5571760,1525692698,1525692710,12,204,11.335475189353847,5.0,1.0,51.42030216766649
5571761,1525692702,1525692756,54,197,10.550486496371896,5.897423537234051,3.4787152380952384,40.33724167274495
5571762,1525692740,1525692774,34,193,17.85035957768487,10.760598945489155,1.0,50.0
5571763,1525692745,1525692774,29,51,36.28995465439501,28.0,20.0,90.38519586776859
5571764,1525692748,1525692774,26,251,3.617290353609754,2.0,1.5,7.955958011869436
5571765,1525692764,1525692782,18,116,8.566221516667667,6.352173968253968,2.2,19.60625850340135
5571766,1525692771,1525692783,12,204,1.9973619747503297,1.0,1.0,8.0
5571767,1525692777,1525692805,28,144,9.929490261845679,7.0,5.0,20.0
5571768,1525692798,1525692813,15,52,14.94343405144062,11.652383271832718,3.0,60.267314168937325
5571769,1525692805,1525692821,16,34,8.765088622485335,6.0,4.348016921985816,28.622513513513365
5571770,1525692813,1525692828,15,129,23.64561498385676,15.0,1.0,59.315358776154405
5571771,1525692822,1525692844,22,257,4.547598306563948,2.0,1.5,20.633281179138294
5571772,1525692840,1525692857,17,155,17.135305926567703,11.398215477727849,4.035117218287186,56.0
5571773,1525692856,1525692872,16,191,13.607097881395884,4.0,1.5,56.0
5571774,1525692863,1525692880,17,119,11.126452403661467,4.0,2.0,55.50774500458294
5571775,1525692873,1525692900,27,117,6.663230412289027,5.0,1.0,14.6743791198044
5571776,1525692895,1525692912,17,195,8.293528809148233,4.0,2.0,27.395032071582357
5571777,1525692911,1525692938,27,195,11.349929188911977,5.697671967980001,2.2,50.0
5571778,1525692936,1525692946,10,197,21.624984460444203,12.0,3.0,50.0
5571779,1525692942,1525692968,26,108,10.265055168302343,4.0,1.0,51.405295099999975
5571780,1525692968,1525692980,12,172,13.851484416349543,10.676679881070367,2.0,50.0
5571781,1525692978,1525693001,23,145,10.482864769967994,5.364256566734399,2.5,50.0
5571782,1525693000,1525693024,24,224,7.13977094092241,2.0,1.5,48.864104253708206
5571783,1525693021,1525693035,14,161,12.347300558109673,5.633032770578352,2.2,50.0
5571784,1525693034,1525693065,31,283,4.075138249101012,1.5,1.5,20.0
5571785,1525693064,1525693087,23,189,16.78034953808066,8.0,3.0,43.18606248270535
5571786,1525693086,1525693097,11,216,8.244117273073284,2.0,1.5,50.0
5571787,1525693092,1525693105,13,105,9.345319335080543,2.7505313623188465,2.0,20.0
5571788,1525693104,1525693118,14,168,13.899377757242883,6.761532465453582,1.0,50.0
5571789,1525693116,1525693126,10,133,8.669183321759954,6.0,2.0,32.48065209734137
5571790,1525693120,1525693144,24,304,3.555458074274778,2.0,1.5,9.3409142403808
5571791,1525693143,1525693162,19,156,13.60525581714052,6.025862392964592,2.0,51.9
5571792,1525693157,1525693179,22,133,10.952056219069336,3.8903918181818185,2.0,60.0
5571793,1525693164,1525693266,102,61,10.67972445559526,6.215778666666667,1.0,33.69518976212747
5571794,1525693169,1525693266,97,11,0.0,0.0,0.0,0.0
5571795,1525693175,1525693267,92,254,6.251082412931225,2.0,1.5,14.607933780626752
5571796,1525693191,1525693267,76,131,5.956077674816183,2.0,2.0,20.0
5571797,1525693196,1525693268,72,56,8.790666386942805,2.5824462306158926,2.0,39.359145882352905
5571798,1525693198,1525693268,70,161,2.5181066029242563,1.0,1.0,2.7241928009058
5571799,1525693204,1525693268,64,211,7.944311121090756,4.851611294117647,1.0,30.0
5571800,1525693230,1525693268,38,215,12.432309945709688,6.0,2.0,41.0
5571801,1525693237,1525693269,32,97,14.497528809290047,6.0,1.4253347155467613,50.0
5571802,1525693257,1525693270,13,234,14.739417640415496,3.3173942908148897,1.0,50.0
5571803,1525693265,1525693286,21,165,9.809853252035698,2.5,2.0,50.0
5571804,1525693277,1525693320,43,76,23.763550228035168,14.46991329527559,1.0,50.0
5571805,1525693321,1525693329,8,132,26.78640322749998,20.0,12.0,58.097889697115335
5571806,1525693327,1525693336,9,5,50.19879471958922,48.78877968772197,36.31835331486897,70.0
5571807,1525693335,1525693352,17,65,9.143993834070914,4.0,2.2,50.0
5571808,1525693349,1525693361,12,28,42.15495115386292,40.896604107027215,20.0,94.72757873880927
5571809,1525693357,1525693389,32,173,7.104248507055694,5.0,2.0,15.022851325909322
5571810,1525693387,1525693417,30,218,7.489472453897666,3.0,2.0,20.99302335600907
5571811,1525693413,1525693418,5,152,12.3094390631729,6.0,2.0,52.03529561981429
5571812,1525693417,1525693452,35,61,4.16252716843911,2.0,1.247444096076289,13.592193539568344
5571813,1525693440,1525693471,31,151,11.564361231166876,6.0,2.0,50.0
5571814,1525693472,1525693484,12,180,12.467425253532854,4.0,2.0,50.07612178520657
5571815,1525693482,1525693492,10,137,7.697400495057555,4.0,1.061146706231454,37.62434454272973
5571816,1525693486,1525693492,6,44,17.278925859961838,4.0,4.0,50.0
5571817,1525693488,1525693499,11,72,4.476208458953257,2.0,2.0,7.0
5571818,1525693496,1525693513,17,91,4.272610958539034,2.0,1.284343434735824,18.56640816326528
5571819,1525693504,1525693520,16,126,10.551552301071299,5.0,2.0,50.0
5571820,1525693517,1525693530,13,157,9.15886482078678,5.0,2.0,22.0
5571821,1525693526,1525693541,15,82,7.517864751195566,2.0,1.2,41.0
5571822,1525693542,1525693560,18,159,8.819090710579705,5.99854618146249,1.2573382241236375,41.0
5571823,1525693556,1525693570,14,220,16.496033337446914,7.029948780487807,1.0,80.0
5571824,1525693563,1525693577,14,77,3.9626653058667483,2.0,1.1,6.915427979373416
5571825,1525693571,1525693578,7,89,19.274070726341353,4.0,1.0866832079207922,50.0
5571826,1525693575,1525693586,11,85,5.019341500015039,4.0,2.0,7.505667308256712
5571827,1525693578,1525693595,17,69,3.669652182330148,1.4263686632600607,1.0,20.551150186913688
5571828,1525693584,1525693606,22,102,4.774643887705301,1.9394943408172398,1.0,15.557380004973883
5571829,1525693598,1525693622,24,161,10.397455455880074,6.0,2.0,50.0
5571830,1525693622,1525693651,29,87,12.446576912765925,10.0,1.7478373493975905,41.0
5571831,1525693645,1525693667,22,25,58.43198218244115,55.745656963713564,40.6636594217348,100.0
5571832,1525693666,1525693680,14,181,15.115450944637772,11.440593052631579,2.9425981852185386,41.0
5571833,1525693681,1525693696,15,170,8.53518224012581,4.4588201509416905,2.0,40.0
5571834,1525693691,1525693705,14,190,6.3567886953907475,4.0,1.0,20.3045178125
5571835,1525693694,1525693713,19,146,4.76398181458585,2.0,1.0,20.0
5571836,1525693707,1525693735,28,173,6.472066684861531,4.0,4.0,20.0
5571837,1525693727,1525693743,16,129,10.161793480671871,4.0,1.3940472662500654,41.0
5571838,1525693744,1525693780,36,144,10.400322332259774,5.176317454376459,2.2,40.0
5571839,1525693746,1525693780,34,14,6.420602510655487,3.519973834790505,2.2626864234522137,32.83341905992248
5571840,1525693774,1525693802,28,161,11.986985889934699,5.123593612589678,2.2,50.0
5571841,1525693801,1525693823,22,21,58.855138161562,50.0,41.0,112.0
5571842,1525693813,1525693832,19,209,17.726834638760895,12.0,2.0,50.0
5571843,1525693818,1525693848,30,99,4.279805020278272,2.0,2.0,8.92467737992187
5571844,1525693841,1525693855,14,35,16.087122529463308,17.225678530314124,0.0,51.979384098108945
5571845,1525693851,1525693872,21,174,11.357669480368386,6.0,4.0,40.0
5571846,1525693867,1525693900,33,114,9.041699943622856,4.0,2.0,40.0
5571847,1525693888,1525693912,24,144,8.924476415482825,6.0,1.3475244938010693,40.0
5571848,1525693900,1525693912,12,148,17.86441068901127,4.0,4.0,50.0
5571849,1525693907,1525693932,25,107,11.807698164417335,4.0,2.0,50.0
5571850,1525693928,1525693943,15,128,14.512061915254906,8.013543951612903,2.0,50.0
5571851,1525693936,1525694014,78,119,10.374547040134841,3.0,2.0,50.0
5571852,1525694015,1525694034,19,187,49.93320605400911,50.0,41.0,52.00337384374839
5571853,1525694030,1525694048,18,234,19.45417141415546,20.0,5.531595458333333,40.0
5571854,1525694045,1525694092,47,202,11.511755951893848,6.078287380410023,4.0,50.0
5571855,1525694091,1525694124,33,152,22.994048640815716,1.4202579744312873,1.0,80.0
5571856,1525694116,1525694143,27,214,17.84617735517158,16.380117798147147,4.0,50.0
5571857,1525694142,1525694156,14,302,17.25729449700094,1.0,1.0,60.94448255999999
5571858,1525694156,1525694184,28,190,8.27679661669883,5.390288614116558,2.5625,24.0
5571859,1525694184,1525694216,32,302,53.331509205040526,50.0,50.0,82.51448981519493
5571860,1525694215,1525694231,16,182,14.767705893561358,11.0,5.0,40.0
5571861,1525694229,1525694239,10,152,50.903144658334476,50.0,50.0,50.0
5571862,1525694234,1525694248,14,147,7.648451213016172,5.0,4.0,25.956274714282642
5571863,1525694241,1525694255,14,147,8.428069768184095,5.895220792402124,2.0,22.27170048701272
5571864,1525694248,1525694257,9,198,7.940205896423722,3.0,1.0,40.0
5571865,1525694252,1525694265,13,186,14.060592837402869,6.0,4.0,50.0
5571866,1525694258,1525694274,16,151,6.6223355246135025,4.0,1.0,25.559924999999925
5571867,1525694265,1525694282,17,13,7.437061128739357,7.424625818995476,2.0,8.0
5571868,1525694273,1525694308,35,161,8.48049609948905,4.0,2.0,40.0
5571869,1525694306,1525694315,9,134,18.4795267934804,4.0,1.0,62.1183297917997
5571870,1525694315,1525694331,16,137,5.801885742930314,5.0,1.5811953397034053,9.611752684990154
5571871,1525694332,1525694398,66,232,32.45649197067966,28.95688333333331,0.0,80.0
5571872,1525694396,1525694407,11,216,7.092335859379223,4.24,4.0,20.218502227366777
5571873,1525694399,1525694408,9,116,6.567997920435263,4.0,1.0,19.951917127071756
5571874,1525694404,1525694428,24,114,10.232991560803303,6.0,2.2,50.0
5571875,1525694426,1525694502,76,161,14.176491515006036,10.0,5.0,50.0
5571876,1525694501,1525694512,11,206,40.40977979153931,40.0,20.0,93.58065999999997
5571877,1525694506,1525694523,17,152,10.865773587349686,10.0,4.0,16.925397860567
5571878,1525694523,1525694541,18,121,17.17339586834406,10.992310737266472,6.0,50.0
5571879,1525694540,1525694551,11,210,10.328808722582776,4.0,4.0,41.0
5571880,1525694546,1525694563,17,180,10.531508835467656,4.0,2.2,50.0
5571881,1525694562,1525694574,12,119,10.555187542326255,6.0,2.0,31.382344916449632
5571882,1525694573,1525694593,20,122,15.107586079927948,6.0,2.1721745018450185,50.0
5571883,1525694591,1525694616,25,138,15.458387757396459,2.0,2.0,50.97660360710552
5571884,1525694614,1525694630,16,192,13.764906845996839,7.942556728671328,1.9786033802816947,49.57533536762593
5571885,1525694620,1525694638,18,119,12.573145958560334,6.0,2.120000011,50.0
5571886,1525694634,1525694647,13,40,44.055948814964374,41.0,20.0,92.19736473684209
5571887,1525694642,1525694648,6,147,7.507767911579963,6.0,2.0,14.950561425632909
5571888,1525694645,1525694663,18,103,4.3047428376919985,2.2,2.0,6.185164549872715
5571889,1525694662,1525694676,14,177,14.411416326356811,7.0,2.0,50.0
5571890,1525694675,1525694721,46,130,5.935241376509515,2.0,2.0,24.0
5571891,1525694720,1525694743,23,221,18.996561273711585,10.0,1.0,50.02392326165181
5571892,1525694742,1525694751,9,73,32.906927120806316,22.0,20.0,91.64464992551606
5571893,1525694745,1525694771,26,165,6.80108836520786,5.0,3.0,15.0
5571894,1525694770,1525694795,25,181,12.75110177143746,4.24,2.188457736711822,57.40483170164465
5571895,1525694794,1525694804,10,188,16.606414510110156,11.86457906403941,3.0,50.0
5571896,1525694797,1525694812,15,139,6.506435121023082,5.084155555555555,2.2,15.119855844188493
5571897,1525694806,1525694829,23,21,43.63303393875502,50.0,22.16643392857143,66.03397865475296
5571898,1525694820,1525694842,22,181,9.120795426690828,6.0,1.0,29.57286356164382
5571899,1525694842,1525694853,11,208,21.321604511961716,6.230900265957448,2.2,50.0
5571900,1525694852,1525694865,13,107,13.39753795162345,6.0,2.0,50.0
5571901,1525694863,1525694896,33,179,5.936486315281316,2.0,1.0,15.930005789649162
5571902,1525694872,1525694915,43,117,15.710405669914403,5.845782464000912,1.0,50.0
5571903,1525694897,1525694924,27,166,12.266488355832545,6.0,3.0,45.943619999999946
5571904,1525694909,1525694932,23,116,6.45303012326721,2.0,1.3125434976609969,29.946981981981953
5571905,1525694914,1525694964,50,138,8.410936409968842,6.0,2.2,40.0
5571906,1525694958,1525694972,14,224,28.065953857616723,20.127122388059703,5.492075999383579,58.606380753729326
5571907,1525694966,1525694994,28,152,6.736217385719474,5.0,2.0,13.917346033325042
5571908,1525694984,1525695003,19,153,10.611365339303381,5.0,1.0,50.0
5571909,1525695001,1525695036,35,107,7.258477284361268,5.042541629606278,1.2,20.941507684891587
5571910,1525695035,1525695045,10,221,14.696647639556378,5.7529080540113275,1.0,50.0
5571911,1525695043,1525695085,42,177,9.389498427028029,5.0,1.0,50.0
5571912,1525695077,1525695107,30,223,23.77599631986877,12.0,5.0,50.0
5571913,1525695108,1525695120,12,146,7.093106984707869,4.0,2.0,35.74203320312496
5571914,1525695111,1525695132,21,93,15.283798527594888,6.0,4.0,50.0
5571915,1525695115,1525695140,25,312,3.868806861376226,1.0,1.0,9.914749435185486
5571916,1525695137,1525695150,13,147,8.901113708160091,5.0,1.2506498250857567,41.0
5571917,1525695144,1525695158,14,174,10.576492555948185,6.0,1.0,50.0
5571918,1525695152,1525695178,26,98,6.867323313260872,2.0,2.0,44.25615287420164
5571919,1525695163,1525695186,23,48,9.144914316038177,6.675418461538461,4.0,26.410867736313854
5571920,1525695181,1525695215,34,126,35.57089676524795,20.0,10.0,112.24
5571921,1525695212,1525695223,11,142,6.788805556209624,6.0,4.0,15.965731218737092
5571922,1525695219,1525695274,55,202,8.33111191128146,4.0,3.0,21.0
5571923,1525695273,1525695283,10,82,121.12135218445226,8.240286908325732,1.1,1400.343223734181
5571924,1525695277,1525695300,23,157,11.889727099477755,6.0,4.0,41.45519785093565
5571925,1525695284,1525695309,25,189,14.16659476427549,10.0,2.2226135042081814,50.0
5571926,1525695305,1525695319,14,216,15.492209067823994,20.0,3.0,34.98652606023801
5571927,1525695316,1525695327,11,151,7.120448159751486,2.0,2.0,36.644371875000004
5571928,1525695323,1525695344,21,131,6.556942426534937,4.0,2.0,20.0
5571929,1525695337,1525695365,28,140,8.934283421491061,5.0,2.0,50.27896855005282
5571930,1525695361,1525695372,11,145,12.08331766388046,6.0,2.5803873612349237,50.0
5571931,1525695367,1525695381,14,155,8.519161187314406,6.0,3.0,23.866767931034428
5571932,1525695373,1525695382,9,59,3.6193827328183055,2.0,2.0,5.0240726750861
5571933,1525695378,1525695406,28,74,7.964073180037857,5.9487185553102435,1.1926171826891185,44.100938666824916
5571934,1525695389,1525695424,35,70,4.707823892065147,2.0,1.0285291029308785,20.109428840970345
5571935,1525695417,1525695463,46,146,22.061521043225127,10.0,5.689362968731066,50.0
5571936,1525695458,1525695470,12,149,13.34436767459476,6.139881692186341,5.0,50.0
5571937,1525695465,1525695481,16,167,8.761473249813353,4.0,2.0,53.294778454159115
5571938,1525695481,1525695491,10,188,8.161461963692195,6.0,3.0,20.0
5571939,1525695491,1525695521,30,109,6.731995610986748,4.0,2.0,24.370768794326214
5571940,1525695520,1525695551,31,33,29.74656013204432,11.565269009441876,5.97,61.5872091990117
5571941,1525695551,1525695560,9,303,10.559759854017305,1.0,1.0,41.172057611575404
5571942,1525695555,1525695569,14,130,8.716220428788148,6.0,1.0,35.84019999999998
5571943,1525695564,1525695578,14,186,24.47729196606957,10.291472881355933,4.0,65.40428377623172
5571944,1525695571,1525695587,16,230,4.65456550757711,4.0,1.0,6.16313695903726
5571945,1525695579,1525695595,16,121,5.1019986954185494,2.0,2.0,27.94376237623761
5571946,1525695588,1525695603,15,92,7.2578832286854205,2.0,1.1,34.51536651583711
5571947,1525695594,1525695615,21,100,1.9381829335743714,1.0484225714285718,1.0,3.0
5571948,1525695614,1525695634,20,167,10.663279122175695,5.3,2.0,50.0
5571949,1525695630,1525695652,22,171,9.971342967717531,6.0,1.0,50.0
5571950,1525695647,1525695660,13,182,11.846222222854538,3.0427655172413797,2.0,50.12593742857142
5571951,1525695653,1525695670,17,114,8.790366511967047,4.0,1.1,50.0
5571952,1525695659,1525695680,21,200,16.872493500688126,5.52503538638985,3.0,56.0
5571953,1525695665,1525695680,15,85,4.227673627893042,2.0,2.0,20.0
5571954,1525695676,1525695701,25,140,6.945662633618284,3.0,2.0,30.0
5571955,1525695694,1525695701,7,112,10.019352686956577,4.0,1.0,50.0
5571956,1525695696,1525695711,15,73,4.176486067187241,1.1,1.0,6.0
5571957,1525695709,1525695732,23,71,9.331702950867095,4.0,1.26565015722295,50.0
5571958,1525695722,1525695732,10,138,7.577807013644639,5.0,2.0,30.0
5571959,1525695730,1525695751,21,69,5.75037906277721,2.0,1.2,21.0
5571960,1525695750,1525695764,14,137,12.517071083424998,6.0,3.0,50.0
5571961,1525695762,1525695772,10,171,8.524877503718505,4.0,3.0,43.59773253049615
5571962,1525695764,1525695776,12,214,7.250258886421191,3.0,3.0,40.59261241379307
5571963,1525695768,1525695784,16,12,7.554138806793295,7.578445283018867,2.2,8.0
5571964,1525695778,1525695792,14,146,9.712546726600921,5.0,1.0,50.0
5571965,1525695782,1525695801,19,93,4.480322148770998,2.0,2.0,6.348858221043578
5571966,1525695793,1525695811,18,111,18.96265009777867,5.138147042109685,2.0,101.2
5571967,1525695809,1525695845,36,103,8.671905995624208,5.030908395604396,2.0,20.842725412063032
5571968,1525695845,1525695892,47,189,12.971830777650863,10.0,2.0002,50.0
5571969,1525695879,1525695901,22,206,16.052178509531636,6.335625284738041,2.0002,51.563530238011005
5571970,1525695891,1525695910,19,150,8.764554551852745,4.0,1.0,41.0
5571971,1525695900,1525695920,20,178,7.178802433515254,4.0,2.0,18.884303870959858
5571972,1525695907,1525695921,14,59,4.893669921113745,1.325096515531867,1.0,31.347992792792507
5571973,1525695914,1525695930,16,15,7.960994059545461,7.78188618272841,4.0,45.95487816848024
5571974,1525695922,1525695975,53,102,12.63016957953112,6.0,4.0,53.917445548786304
5571975,1525695974,1525695984,10,128,11.516875712459989,5.0,3.0,41.0
5571976,1525695981,1525696003,22,276,8.985850133394765,2.0,1.0,50.0
5571977,1525695990,1525696012,22,92,7.091509617314256,5.970262122425852,2.0,17.911202709831166
5571978,1525696007,1525696023,16,154,10.770781756423842,5.657155180392158,1.0,50.0
5571979,1525696020,1525696054,34,198,8.524622304043264,4.0,1.0,50.0
5571980,1525696050,1525696075,25,179,16.414191772002262,9.230121247023257,4.0,50.0
5571981,1525696055,1525696075,20,179,6.489389802693774,2.0,1.435386647760292,22.850695666951147
5571982,1525696067,1525696099,32,186,5.473122951925166,1.8,1.0,28.0
5571983,1525696074,1525696099,25,232,14.906186486867757,6.0158923397361725,3.0,50.0
5571984,1525696092,1525696118,26,121,9.021122928001413,4.0,2.0,21.782373020344288
5571985,1525696099,1525696127,28,67,10.817906305473572,2.0,2.0,28.837364999999828
5571986,1525696103,1525696127,24,23,14.851781238001918,6.04578139319602,4.0,50.0
5571987,1525696113,1525696127,14,28,27.706906555812754,20.0,20.0,50.0
5571988,1525696120,1525696144,24,197,10.496283064386011,6.128611663966675,2.2,50.0
5571989,1525696143,1525696151,8,163,10.47370027352262,5.8178410940889504,2.0,20.196908972376328
5571990,1525696148,1525696175,27,153,6.111988853201046,5.0,1.0,20.0
5571991,1525696168,1525696197,29,202,11.965123714271002,5.0,2.0,56.0
5571992,1525696194,1525696207,13,165,10.797835539189665,5.8867345811320755,2.0,30.0
5571993,1525696200,1525696234,34,60,6.631235437423502,3.0810953086419754,2.2,6.019988380071598
5571994,1525696205,1525696270,65,30,10.95555991319341,9.527815040024631,2.0,33.16463266365664
5571995,1525696206,1525696271,65,206,2.9180137374084314,2.0,1.44792163308198,7.5592285057471225
5571996,1525696215,1525696272,57,171,9.899692055761825,6.0,2.2,22.0
5571997,1525696233,1525696272,39,211,35.13683625986938,50.0,1.0,50.0
5571998,1525696238,1525696272,34,105,10.60748145408547,5.76012566711886,2.0,50.0
5571999,1525696245,1525696277,32,83,4.90516881103575,1.977216857798165,1.2,24.19150862499974
5572000,1525696254,1525696277,23,132,10.325748432376017,5.781579264059246,2.0,50.0
5572001,1525696261,1525696289,28,99,8.250749630302256,2.2,2.0,50.0
5572002,1525696288,1525696338,50,154,18.550889165079,1.1,1.0,67.65970263636362
5572003,1525696334,1525696359,25,188,18.156046716615023,12.149354,6.0,50.0
5572004,1525696360,1525696381,21,223,23.952071822855853,20.0,5.604903085766921,51.95138931541354
5572005,1525696366,1525696381,15,172,5.726844627080454,4.0,2.666437642761111,14.128440350877131
5572006,1525696380,1525696401,21,36,35.58388100411732,41.0,20.0,50.02985699008537
5572007,1525696401,1525696410,9,147,12.993661335788042,6.0,4.0,37.60787409945059
5572008,1525696405,1525696424,19,195,6.732286479901582,4.0,3.0,22.944311497286552
5572009,1525696415,1525696435,20,172,7.626173606407996,5.429154760647457,2.0,20.0
5572010,1525696422,1525696452,30,139,6.727936513633262,3.0,2.0,20.0
5572011,1525696442,1525696452,10,136,9.48396049431445,5.681906525224684,3.0,20.0
5572012,1525696449,1525696461,12,172,6.103373678928684,2.0,1.5,30.0
5572013,1525696453,1525696485,32,144,4.894665906710202,2.000009468224948,1.0,17.28782392439691
5572014,1525696482,1525696524,42,170,11.032876990277932,4.0,1.0,50.0
5572015,1525696523,1525696542,19,202,17.09820059425893,11.9883739119622,3.5234302702702704,50.0
5572016,1525696541,1525696551,10,254,7.797152292612794,4.0,1.0,21.0
5572017,1525696545,1525696573,28,227,10.345198366374888,4.0,1.0,54.0
5572018,1525696574,1525696595,21,173,10.66273122659074,5.460489520179878,2.0,41.0
5572019,1525696595,1525696617,22,142,16.43463537431629,6.0,4.0,50.0
5572020,1525696616,1525696626,10,169,10.289513916879159,6.0,2.0,47.84574639999998
5572021,1525696622,1525696634,12,176,6.91833180398121,2.0,1.4358263634512518,23.065108767501933
5572022,1525696628,1525696644,16,160,12.697558566534761,6.0,2.0,50.0
5572023,1525696637,1525696668,31,163,11.213650709457546,6.0,3.0,50.0
5572024,1525696659,1525696668,9,134,15.379731707876427,8.0,4.0,50.0
5572025,1525696664,1525696683,19,133,8.015450954994142,4.0,3.0,20.0400459259259
5572026,1525696682,1525696693,11,36,19.5665429773278,5.354158099999999,4.0,59.543484132841314
5572027,1525696691,1525696715,24,197,10.353493657925549,6.0,3.0,41.08690076961342
5572028,1525696709,1525696729,20,215,6.638170387168517,5.0,1.0,20.0
5572029,1525696728,1525696746,18,38,39.127932814418,24.0,20.0,91.0
5572030,1525696745,1525696756,11,175,11.342984066963993,6.0,1.0,40.41961839826983
5572031,1525696750,1525696768,18,190,6.279464006539674,4.0,2.2052614420916004,20.0
5572032,1525696764,1525696782,18,133,7.624445189697943,2.1,2.0,50.0
5572033,1525696783,1525696801,18,109,11.684958409890093,6.830972500000003,4.0,30.73358849344958
5572034,1525696802,1525696821,19,45,40.6099956101523,23.01502380952381,20.0,112.0
5572035,1525696819,1525696829,10,153,6.7087187726348825,4.0,2.0,22.0
5572036,1525696826,1525696845,19,176,11.893435000806122,4.0,2.2,50.0
5572037,1525696843,1525696877,34,109,8.627462783942416,4.015091512207147,2.0,25.52224841851312
5572038,1525696876,1525696887,11,137,8.930569049090474,4.183909164549405,2.0,30.0
5572039,1525696884,1525696896,12,64,10.402381197425042,6.0,2.1582235931350833,40.23286638074024
5572040,1525696888,1525696911,23,131,8.597556138704679,4.0,2.0,50.0
5572041,1525696904,1525696919,15,114,7.881148322729913,4.0,2.0,28.673560248721945
5572042,1525696917,1525696929,12,214,10.00173614267826,3.0,1.0,50.0
5572043,1525696929,1525696955,26,59,25.81732431269397,15.822145410923,12.0,64.34150072735072
5572044,1525696954,1525696965,11,115,11.667940989097602,10.0,4.257079319611603,50.0
5572045,1525696965,1525697019,54,202,9.444909606889947,4.0,1.0,50.0
5572046,1525697020,1525697039,19,332,22.773496789121673,1.0,1.0,60.0
5572047,1525697040,1525697054,14,213,37.31929433281994,41.0,12.0,70.0
5572048,1525697054,1525697072,18,116,9.277384521615316,6.0,5.0,40.48380999999997
5572049,1525697059,1525697072,13,201,4.3205139151644785,4.0,1.0,5.741117677142856
5572050,1525697062,1525697082,20,194,7.31021024335099,4.0,3.0,50.0
5572051,1525697073,1525697095,22,195,10.619952983443767,4.798683111710665,1.0,50.0
5572052,1525697095,1525697103,8,188,12.298365111110147,4.065776108361819,3.0,50.774749224999994
5572053,1525697101,1525697112,11,160,11.219441446222381,6.0,2.2,55.0
5572054,1525697105,1525697121,16,204,3.9305500637936777,1.9116369198084056,1.0208004438843579,6.182083637971698
5572055,1525697112,1525697130,18,183,14.709134320076016,7.879048475035852,3.0,55.0
5572056,1525697127,1525697146,19,183,12.8618964992659,12.0,3.0,20.772009523809523
5572057,1525697133,1525697165,32,141,3.9090463396637225,2.39006299725259,1.0,10.010858764952884
5572058,1525697162,1525697184,22,169,15.406988967274486,5.0,2.0,90.0
5572059,1525697177,1525697197,20,107,7.946973851289995,5.0,1.4895656493780138,21.731226095508624
5572060,1525697196,1525697205,9,164,9.363403792267148,5.288214054797885,1.5,42.86381609376381
5572061,1525697199,1525697213,14,164,2.616190404356875,1.9564878922417162,1.1,3.7853637834845077
5572062,1525697205,1525697223,18,99,8.06326056324266,2.0,2.0,28.07505882352941
5572063,1525697217,1525697231,14,228,11.97396156544721,6.0,3.0,50.0
5572064,1525697224,1525697239,15,70,5.498440427910413,2.0,1.115944028399568,20.84112264
5572065,1525697227,1525697246,19,93,5.676195443044373,2.0,2.0,20.0
5572066,1525697235,1525697274,39,62,8.468420305410808,5.0,1.2071936643699925,31.2050152631578
5572067,1525697275,1525697293,18,180,12.086017838431536,6.0,2.0,41.0
5572068,1525697286,1525697313,27,84,10.564847807450846,5.0,1.2,50.0
5572069,1525697304,1525697344,40,157,7.040615825477894,4.0,1.0,12.04913027777777
5572070,1525697329,1525697353,24,95,10.774960662692338,5.6991218484647375,4.0,41.0
5572071,1525697343,1525697361,18,15,47.72901395513421,44.99148487453131,25.990043205722987,74.94097520661153
5572072,1525697360,1525697370,10,171,10.109105646325787,6.0,2.0,41.0
5572073,1525697366,1525697377,11,56,8.819473204221868,4.609421393432747,1.1352253011249323,50.57311921538461
5572074,1525697370,1525697385,15,172,9.645477960764632,6.0,3.0,50.0
5572075,1525697379,1525697392,13,112,7.335164177530722,2.0,1.0,24.0
5572076,1525697384,1525697393,9,101,3.3623772171792123,2.0,1.0,6.17824113399676
5572077,1525697392,1525697402,10,177,4.263010951355409,1.0,1.0,22.35636705882351
5572078,1525697401,1525697439,38,92,15.510971630074,12.0,4.0,50.0
5572079,1525697428,1525697461,33,144,15.035644294954098,5.0,1.0,58.493735553379025
5572080,1525697457,1525697461,4,174,8.307712846862694,5.203627770963096,1.0,30.0
5572081,1525697460,1525697471,11,74,9.990694850455801,5.908552752293578,3.0,44.741470582260646
5572082,1525697466,1525697482,16,113,2.074984600536027,2.0,1.0,2.0
5572083,1525697478,1525697492,14,112,12.48772275714209,6.0,3.0,35.80826470588235
5572084,1525697480,1525697500,20,122,5.182060221188405,2.0,1.0,19.95225080126231
5572085,1525697491,1525697508,17,75,11.935979248110344,5.169203425588982,2.2,50.0
5572086,1525697501,1525697536,35,110,3.6118052175951396,2.0,2.0,8.237338738738732
5572087,1525697527,1525697554,27,175,19.231299711187788,10.0,3.0,52.171682475961454
5572088,1525697549,1525697561,12,204,12.695928917306894,6.0,2.0,50.0
5572089,1525697556,1525697592,36,104,2.622503069962248,2.0,1.0,5.633321670044232
5572090,1525697584,1525697619,35,200,16.019001897326575,6.159548093463303,3.826215182648402,55.0
5572091,1525697617,1525697627,10,185,11.298655808978873,6.0,2.0,50.0
5572092,1525697620,1525697628,8,219,8.798915877143513,6.0,3.0,33.75996833333317
5572093,1525697627,1525697644,17,92,4.206646850283362,2.0,2.0,10.61886743848486
5572094,1525697644,1525697679,35,169,13.27149615191781,6.0,3.0,50.0
5572095,1525697677,1525697691,14,112,18.33129170506897,8.384941169556637,5.0,59.27544041999999
5572096,1525697683,1525697722,39,151,6.792558036745179,5.0,2.0,18.364910641867507
5572097,1525697722,1525697735,13,139,19.456186207138078,12.222833634535803,5.0,50.0471573153964
5572098,1525697734,1525697751,17,160,15.37422287976662,6.0,4.0,55.81719731380252
5572099,1525697737,1525697768,31,145,3.5717248291856944,2.0,2.0,6.565141822222222
5572100,1525697767,1525697797,30,42,47.691733924132315,50.0,23.0,99.68138079470198
5572101,1525697796,1525697811,15,167,14.752680605294747,10.0,3.3497056338028233,50.0
5572102,1525697810,1525697819,9,198,8.236793135324039,4.0,3.0,39.78906953394191
5572103,1525697816,1525697828,12,199,9.37798102332914,4.0,3.0,50.0
5572104,1525697822,1525697857,35,117,2.6041224282267446,2.0,1.5,2.5
5572105,1525697857,1525697885,28,109,31.03123262566527,20.0,12.0,91.0
5572106,1525697873,1525697897,24,209,9.05133650436554,6.0,4.0,38.0
5572107,1525697890,1525697907,17,118,9.113527038997827,6.0,1.0,29.83121666666663
5572108,1525697899,1525697919,20,118,8.0482059115791,3.0,2.0,34.71175468514254
5572109,1525697918,1525697929,11,190,11.612424819054683,6.0,3.0,50.0
5572110,1525697928,1525697943,15,252,2.064118729587318,1.0,1.0,5.779204882812499
5572111,1525697935,1525697950,15,82,9.778740335699647,5.952104594174355,2.1,41.0
5572112,1525697941,1525697956,15,190,7.144146126518864,5.990549803142421,1.0,14.786764547677262
5572113,1525697951,1525697966,15,64,8.101118294985186,5.0,3.0,40.82960588763051
5572114,1525697967,1525697980,13,231,9.774554153522645,4.0,1.0,49.478837638376355
5572115,1525697980,1525698004,24,118,11.676470209252825,5.419161482204495,3.0,50.0
5572116,1525698004,1525698035,31,133,11.866785708602041,5.0,2.0,50.0
5572117,1525698034,1525698049,15,168,10.940327227002498,6.023425133071048,2.0,40.0
5572118,1525698037,1525698073,36,43,45.481583713704985,50.0,20.0,60.0
5572119,1525698070,1525698082,12,174,11.47219456743687,6.0,1.0,41.0
5572120,1525698081,1525698091,10,11,44.59836390530118,50.0,31.8,50.0
5572121,1525698088,1525698120,32,15,9.9524097542454,8.275758064516129,8.0,28.900742265643164
5572122,1525698117,1525698137,20,161,14.298050474284475,8.0,4.0,50.0
5572123,1525698136,1525698144,8,13,21.663344909154965,12.051274038461539,2.0,100.0
5572124,1525698137,1525698152,15,132,9.130834216045594,5.0,1.0,30.0
5572125,1525698144,1525698164,20,202,12.706726441795452,4.5,3.0,50.0
5572126,1525698148,1525698209,61,180,8.795982456284646,4.0,3.0,50.0
5572127,1525698158,1525698209,51,23,42.83830203282265,50.0,22.792928391603855,50.0
5572128,1525698160,1525698210,50,174,4.965550251049555,4.0,1.5,12.67519415422391
5572129,1525698169,1525698210,41,100,3.416015091515964,2.0,2.0,6.025801628217312
5572130,1525698192,1525698210,18,185,12.445430066502865,6.0,3.0,50.0
5572131,1525698198,1525698211,13,205,7.27180696574671,3.0,3.0,25.67021809954749
5572132,1525698205,1525698223,18,115,8.524897690634019,5.696350568181818,3.0,32.59304412687595
5572133,1525698221,1525698251,30,171,14.298376860436333,6.0,3.0,50.0
5572134,1525698250,1525698265,15,208,13.110405419612688,6.0,3.0,50.0
5572135,1525698263,1525698273,10,71,11.332165303330015,6.0,4.0,28.0
5572136,1525698269,1525698289,20,37,6.274423491756909,6.0,3.0,9.619901927007298
5572137,1525698277,1525698299,22,38,7.534678117460261,3.9859306669005408,3.0,26.382653026634383
5572138,1525698280,1525698299,19,147,13.54483256786788,6.0,3.0,55.0
5572139,1525698288,1525698300,12,232,3.608647546076587,2.0,1.5,7.8896785486480265
5572140,1525698294,1525698309,15,77,4.8164193511250435,2.2,2.0,8.6807724455955
5572141,1525698309,1525698341,32,164,10.519518099549686,4.77935577436837,1.0,45.704500239910764
5572142,1525698340,1525698353,13,257,13.22234311163029,5.0,1.0,50.0
5572143,1525698350,1525698377,27,87,10.697174312011382,6.0,4.977268955427781,30.0
5572144,1525698377,1525698419,42,161,10.209953226573786,6.0,4.0,42.0
5572145,1525698410,1525698420,10,28,37.56982777782036,50.0,2.222376801801802,63.29348888020463
5572146,1525698416,1525698455,39,219,10.750634963871656,4.941703260245581,1.0,41.0
5572147,1525698454,1525698465,11,157,12.256167054856826,5.838137306852109,3.0,49.87145855242099
5572148,1525698463,1525698493,30,83,9.970817156122477,5.942877558661631,4.0,30.0
5572149,1525698492,1525698511,19,165,18.9477276962186,12.0,4.0,60.15907179236043
5572150,1525698503,1525698527,24,63,6.441432210289495,5.181011567855443,3.0,9.621015624999934
5572151,1525698527,1525698546,19,105,11.448835653032107,6.0,4.0,31.03185205882349
5572152,1525698540,1525698547,7,96,8.635971647091115,5.0957066,3.0,32.315827382805246
5572153,1525698546,1525698562,16,93,9.42273829902471,6.0,3.0,41.63706787330299
5572154,1525698555,1525698571,16,228,23.66512301714966,9.351716981132075,4.0,50.0
5572155,1525698563,1525698578,15,169,7.80793755944253,6.0,3.0,15.0
5572156,1525698572,1525698586,14,177,10.779166581987203,4.90625,3.0,50.0
5572157,1525698577,1525698604,27,178,4.864326063003875,5.0,3.0,9.191058458690115
5572158,1525698595,1525698613,18,206,11.491136202864206,5.0,3.0,50.0
5572159,1525698608,1525698620,12,164,6.772375915643893,3.16266,2.0,29.58161374999999
5572160,1525698611,1525698620,9,93,4.521373601990764,2.0,2.0,6.178353828306264
5572161,1525698617,1525698628,11,11,9.27613831674224,7.71087588923077,2.044014135003002,33.487066996245304
5572162,1525698620,1525698630,10,102,6.756612826753017,6.0,3.0,10.0
5572163,1525698624,1525698650,26,80,6.323761837887518,3.0,1.2355873591246538,15.822461900884974
5572164,1525698646,1525698669,23,114,16.14140507912082,5.074584259926141,2.0,51.9
5572165,1525698671,1525698684,13,125,10.465828455525706,6.0,2.0,43.97983938027914
5572166,1525698675,1525698704,29,119,6.058507828156466,3.0,2.2,16.38309302325576
5572167,1525698698,1525698713,15,117,16.263311534236948,6.0,4.0,60.0
5572168,1525698712,1525698723,11,267,46.12804685904328,50.0,6.0,50.0
5572169,1525698722,1525698731,9,115,5.704203751760674,4.0,2.0,13.978844229828848
5572170,1525698725,1525698739,14,75,3.2151216393528768,2.0,1.0,8.156746363636357
5572171,1525698731,1525698746,15,150,7.076788806057982,4.0,1.0,27.53172352941173
5572172,1525698737,1525698747,10,80,4.1732844055265215,2.0,1.0,11.5442561391129
5572173,1525698746,1525698768,22,142,8.180240684217756,6.0,2.0,28.0
5572174,1525698768,1525698777,9,112,8.518608075608082,4.0,1.8285245906862484,47.14167146602315
5572175,1525698773,1525698785,12,119,4.650735684447792,1.0,1.0,47.87932463281664
5572176,1525698779,1525698793,14,68,10.538491629649496,6.0,1.829275714285715,50.0
5572177,1525698790,1525698802,12,124,9.927555442991183,4.440580178637843,1.1,41.0
5572178,1525698803,1525698819,16,113,19.757428230132923,7.9883312177707255,2.5013198706099815,55.0
5572179,1525698810,1525698826,16,63,5.1528244737418065,5.0,1.0,6.0
5572180,1525698813,1525698832,19,29,5.644832584421454,3.4812571986836693,1.0,10.0
5572181,1525698827,1525698841,14,93,6.0080753520446475,4.0,2.0,30.59504206574799
5572182,1525698830,1525698873,43,12,27.335803778024562,35.281288288288295,1.1,50.0
5572183,1525698873,1525698897,24,156,14.464055377715873,6.0,4.0,50.0
5572184,1525698879,1525698912,33,65,9.803322062984439,4.0,3.0,33.25032120901691
5572185,1525698911,1525698933,22,138,10.80884912708197,8.170506904069768,2.0,30.0
5572186,1525698922,1525698933,11,71,11.77282196364121,2.2537906480867065,1.0000001,50.0
5572187,1525698926,1525698945,19,106,11.043548737804347,6.0,4.0,28.0
5572188,1525698933,1525698954,21,84,7.395068582250462,6.0,2.0,14.228403520782395
5572189,1525698949,1525698976,27,188,13.282294149213378,5.012958018181818,1.0,50.0
5572190,1525698975,1525698984,9,136,13.98084605131274,6.195227725063643,2.0,40.59805800305981
5572191,1525698979,1525699002,23,27,26.74852456391595,20.28869096927379,20.0,68.66607790137134
5572192,1525699000,1525699010,10,187,13.326934291211415,7.959733031674198,4.0,50.0
5572193,1525699007,1525699024,17,107,4.986788886141252,5.0,1.0,6.173190275399214
5572194,1525699013,1525699034,21,177,8.403277619541928,5.0,2.160139263157895,20.0
5572195,1525699021,1525699046,25,105,4.752094918066666,2.888329117616467,1.1,6.899936304347824
5572196,1525699045,1525699060,15,119,10.384398373367642,5.0366098851298045,2.0,20.0
5572197,1525699051,1525699067,16,152,8.559470108700019,4.0,2.2,20.0
5572198,1525699059,1525699088,29,104,10.682372873990795,6.0,2.2,20.0
5572199,1525699088,1525699104,16,85,61.37820845469958,50.0,20.0,100.0
5572200,1525699103,1525699113,10,116,12.481722897599255,9.201413845967418,4.0,21.0
5572201,1525699112,1525699134,22,186,9.631851583656275,4.0,1.0,43.0306106712563
5572202,1525699132,1525699157,25,210,25.719440229051767,14.199655012224937,4.0,100.0
5572203,1525699158,1525699169,11,191,21.201133513040784,8.02150745967742,4.0,55.0
5572204,1525699166,1525699183,17,123,10.028182183465198,7.547673012322019,1.5,21.048869040627924
5572205,1525699174,1525699190,16,105,21.330810776249407,3.0,2.0,100.0
5572206,1525699185,1525699190,5,66,7.267014586615413,5.0,2.0,30.0
5572207,1525699187,1525699198,11,187,13.311166882236975,15.429563322542464,3.0,20.65822855201061
5572208,1525699195,1525699213,18,28,41.57166962152367,50.0,16.47394019607843,56.59539378063725
5572209,1525699203,1525699221,18,142,14.526348229608972,20.0,2.2,24.22757638376383
5572210,1525699212,1525699229,17,112,10.597160247457124,3.0,2.0,50.0
5572211,1525699222,1525699238,16,94,12.532142857089807,6.1139234436473044,1.0,30.0
5572212,1525699230,1525699256,26,123,13.60755013182642,18.508432450752547,2.0,20.0
5572213,1525699251,1525699289,38,352,6.168360133444597,1.0,1.0,47.99806584909066
5572214,1525699288,1525699298,10,26,34.55632989890801,28.187529411764714,2.0,103.17316198347105
5572215,1525699293,1525699323,30,192,16.17675344711104,12.0,5.0,50.0
5572216,1525699322,1525699345,23,102,14.833204745716918,10.62710855469074,4.920692797417794,41.0
5572217,1525699345,1525699363,18,238,11.168063623480624,5.6875,1.0,50.0
5572218,1525699351,1525699373,22,78,9.884154087626504,5.074189127135191,3.0,20.947158126912722
5572219,1525699373,1525699393,20,97,11.932859417988473,5.1,4.0,51.9
5572220,1525699385,1525699412,27,293,45.86833456454985,50.0,7.0,50.0
5572221,1525699411,1525699421,10,146,13.977168983803377,7.419340709090909,3.0,50.0
5572222,1525699418,1525699431,13,112,5.941676514735651,3.021567213114754,2.0,24.101133333333223
5572223,1525699424,1525699464,40,63,8.46733487488736,4.0,2.0,27.718439560439556
5572224,1525699462,1525699483,21,197,12.716050181324437,7.0,4.0,50.0
5572225,1525699476,1525699484,8,86,11.130668452268106,5.878578983833719,2.0,26.319261538461436
5572226,1525699479,1525699504,25,125,12.220657099635464,3.0,3.0,50.0
5572227,1525699501,1525699512,11,180,14.616585622468117,6.023479907693687,2.5213402181818187,50.0
5572228,1525699510,1525699591,81,53,12.233604822660123,5.0,2.2,51.9
5572229,1525699589,1525699609,20,219,35.174325226319844,27.9862569975808,8.052878749685314,110.6634047619041
5572230,1525699604,1525699615,11,104,10.605338485092632,6.0,4.0,22.83739578801203
5572231,1525699610,1525699616,6,93,8.469968235881309,6.0,4.0,30.0
5572232,1525699613,1525699626,13,165,3.3155279833716476,4.0,1.0,6.55989139489426
5572233,1525699625,1525699645,20,124,8.424678565428149,5.9857200149989245,2.0481145632855546,28.0
5572234,1525699641,1525699676,35,101,9.888384319541792,4.0,1.2185247421665777,46.03878177393171
5572235,1525699675,1525699684,9,313,9.962403465325306,1.0,1.0,50.0
5572236,1525699684,1525699693,9,132,10.369156160779903,6.0,2.2,20.76941450980392
5572237,1525699687,1525699706,19,78,4.222136842578803,4.0,2.0,14.942559106535109
5572238,1525699703,1525699738,35,193,10.976274559585107,6.0,3.0,50.0
5572239,1525699738,1525699744,6,52,17.951574707277107,4.44077922077922,0.0,50.04696293659406
5572240,1525699740,1525699751,11,7,17.35203376971864,12.0,12.0,50.004727153090556
5572241,1525699744,1525699758,14,127,9.179998674167068,6.0,1.0,40.0
5572242,1525699755,1525699765,10,307,3.7062672785848516,1.0,1.0,17.137454742306026
5572243,1525699760,1525699772,12,136,7.130256110660806,6.0,3.0,18.430564895223927
5572244,1525699767,1525699794,27,16,38.08870012781984,21.0,20.0,99.71429882352942
5572245,1525699788,1525699801,13,104,10.409059688369133,6.060552366117568,4.0,30.804542187499997
5572246,1525699793,1525699821,28,172,7.32281185582459,3.0,1.0,44.28644736842093
5572247,1525699813,1525699837,24,187,26.892229762960138,20.0,5.0,50.0
5572248,1525699827,1525699853,26,179,9.023718009204481,6.0,3.0,30.0
5572249,1525699850,1525699870,20,135,6.220020222024905,4.836767792207771,2.0,22.66098558558557
5572250,1525699864,1525699878,14,152,10.272789141440208,5.991900417475728,3.0,41.0
5572251,1525699869,1525699903,34,79,6.146302825253052,2.0,2.0,19.410482560720126
5572252,1525699903,1525699913,10,50,28.518514010040548,20.918122581675966,12.0,53.82545997932797
5572253,1525699906,1525699921,15,109,17.505361276804194,6.0,4.0,43.2143078995317
5572254,1525699914,1525699930,16,165,10.036766715095972,4.141952968772413,3.0,57.16182785722514
5572255,1525699919,1525699940,21,79,8.400693897800572,5.0,2.002,35.78609108656514
5572256,1525699930,1525699949,19,44,50.97317044615996,50.0,21.0,112.0
5572257,1525699940,1525699973,33,55,9.170169527477364,6.0,4.0,20.99280444444443
5572258,1525699970,1525700012,42,140,21.085827174399917,8.0,5.993746217591334,61.0
5572259,1525700012,1525700022,10,208,12.00480695223692,6.0,1.0,50.0
5572260,1525700021,1525700041,20,112,6.997968704252859,5.21,4.0,12.0
5572261,1525700040,1525700060,20,76,13.957390188345284,5.0,4.130127887723412,54.12050084921719
5572262,1525700055,1525700078,23,169,7.218074109242488,4.0,4.0,21.608018091120716
5572263,1525700069,1525700078,9,202,13.932681465143686,6.0,1.0,50.0
5572264,1525700076,1525700086,10,11,8.29019386246301,7.54395594678384,3.0099113873831778,39.11465699507389
5572265,1525700080,1525700100,20,119,4.71886554434785,3.0,2.0,10.0
5572266,1525700097,1525700116,19,184,6.883881866286689,3.0,2.0,20.73369520328182
5572267,1525700109,1525700124,15,38,51.37572956350001,50.0,40.0,55.919923333333315
5572268,1525700112,1525700132,20,178,10.636238697385817,5.430911525044088,1.0,50.0
5572269,1525700126,1525700144,18,276,15.473643255573002,4.0,1.0,57.00460430950047
5572270,1525700141,1525700151,10,108,9.891610212540632,6.0,3.0,41.0
5572271,1525700150,1525700168,18,343,38.34351800949868,50.0,6.0,50.0
5572272,1525700165,1525700176,11,168,37.95574390930761,50.0,5.0,50.0
5572273,1525700176,1525700194,18,141,50.667698585931944,50.0,50.0,50.0
5572274,1525700189,1525700212,23,157,16.129591832094526,6.0,3.0,60.0
5572275,1525700200,1525700233,33,215,8.588595737566044,2.0,1.0,57.73190517104821
5572276,1525700231,1525700260,29,175,13.01775263417762,6.0,3.0,50.0
5572277,1525700255,1525700271,16,118,16.791424254136867,5.0,2.266863061403509,58.82269000916589
5572278,1525700264,1525700271,7,65,7.571617242287946,5.2384918484500576,2.4393465439092354,24.0
5572279,1525700271,1525700322,51,14,4.297718641993392,3.8864402734015933,2.1168929320487413,5.0
5572280,1525700316,1525700330,14,194,17.84169871901956,10.0,5.0,50.0
5572281,1525700326,1525700360,34,100,7.7369849201529,5.0,3.0,20.0
5572282,1525700355,1525700368,13,150,41.02454318626133,50.0,20.0,61.0
5572283,1525700363,1525700394,31,169,12.292709931352176,6.2,5.0,50.0
5572284,1525700388,1525700402,14,170,12.867970870512714,5.0,4.0,50.0
5572285,1525700392,1525700408,16,98,7.691339073939593,5.0,1.0,40.912596522425666
5572286,1525700404,1525700417,13,103,10.81481298161846,4.0,3.0,50.0
5572287,1525700410,1525700426,16,128,4.253289522691855,2.0,1.0,9.562244943820225
5572288,1525700416,1525700433,17,186,15.010903200556516,6.0,3.0,50.0
5572289,1525700423,1525700447,24,119,14.006777444119255,6.0,3.0,50.0
5572290,1525700443,1525700498,55,238,12.00253730143348,6.0,3.0,50.0
5572291,1525700497,1525700514,17,173,38.49543414967558,41.0,7.16133743914111,60.0
5572292,1525700510,1525700523,13,103,8.617247736045954,6.0,5.5,13.489521133004926
5572293,1525700519,1525700530,11,117,8.711755821467191,5.0,5.0,50.0
5572294,1525700522,1525700538,16,114,4.841110985372229,5.0,1.0,5.0
5572295,1525700527,1525700546,19,98,6.360403638423794,3.0,1.0,16.99501351351346
5572296,1525700537,1525700553,16,20,40.1514830060765,50.0,10.669833433502191,50.054797693102884
5572297,1525700546,1525700559,13,107,32.60970462173406,26.058918918918902,0.0,55.23142438130155
5572298,1525700549,1525700567,18,103,8.00110368225644,5.0,2.0,28.0
5572299,1525700556,1525700568,12,194,4.5745726382221035,2.0,1.0,20.183989019607836
5572300,1525700558,1525700589,31,98,2.850069705573557,2.0,1.0,8.83957031111111
5572301,1525700588,1525700605,17,212,11.433367833572794,6.061879151291513,1.0,30.0
5572302,1525700603,1525700629,26,174,10.66127128893925,5.0,3.0,50.0
5572303,1525700628,1525700648,20,148,12.185098973436583,7.0,3.0,30.0
5572304,1525700641,1525700650,9,204,10.705269717516336,2.002,1.0,50.0
5572305,1525700648,1525700662,14,13,7.755443787517995,7.90183393501805,5.259124210526315,10.129272236180904
5572306,1525700661,1525700672,11,63,42.1947869363149,50.0,20.0,90.7391558265124
5572307,1525700671,1525700698,27,175,12.1002470085068,8.014468206504123,1.0,50.0
5572308,1525700695,1525700712,17,165,12.836193813626762,5.997245985540508,3.0,50.0
5572309,1525700707,1525700712,5,73,9.99702193561763,6.0,5.0,28.0
5572310,1525700709,1525700738,29,140,24.214861344306325,20.0,12.0,57.56282976917929
5572311,1525700738,1525700747,9,153,6.363180867571868,5.0,2.002,20.0
5572312,1525700744,1525700766,22,80,9.351130990155658,5.0,2.0,33.250346477497075
5572313,1525700764,1525700774,10,116,16.689622419675022,14.888168534977064,2.002,50.0
5572314,1525700768,1525700774,6,225,9.21320686165272,6.0,3.0,20.0
5572315,1525700772,1525700790,18,11,7.532746141120835,7.563088913950864,2.2,8.0
5572316,1525700789,1525700808,19,152,10.481812729765036,6.0,2.0,40.0
5572317,1525700807,1525700816,9,120,6.744793995643713,2.9992589648043495,2.0,20.0
5572318,1525700812,1525700834,22,130,11.81249973608178,6.0,3.0,50.0
5572319,1525700831,1525700844,13,200,11.577226511618502,5.0,3.0,44.06747906976735
5572320,1525700840,1525700858,18,95,11.3467381682008,6.1206021754223565,1.0,43.755235641763754
5572321,1525700846,1525700880,34,10,41.39184452674078,50.0,20.0,66.5954272131066
5572322,1525700880,1525700916,36,112,24.25393628131439,20.0,12.0,52.71301838147261
5572323,1525700916,1525700940,24,142,15.107025026797261,10.0,6.0,50.0
5572324,1525700933,1525700961,28,95,9.346493498566211,5.896990457088689,5.0,20.0
5572325,1525700959,1525700982,23,194,13.648648169686544,5.0,3.0,56.656406232813936
5572326,1525700982,1525700993,11,223,14.464138729995055,10.0,1.0,50.0
5572327,1525700992,1525701000,8,147,6.347912855600642,5.0,3.0,10.595663222222113
5572328,1525700997,1525701023,26,144,6.981984758309442,3.0,2.008183201110537,28.0
5572329,1525701021,1525701025,4,147,9.892989436988882,5.0,2.0,31.8
5572330,1525701023,1525701045,22,215,6.882790044694654,4.756851989509835,3.0,28.0
5572331,1525701031,1525701045,14,63,7.406743920066741,2.0,2.0,39.72037080894512
5572332,1525701034,1525701053,19,15,35.49731182795699,35.0,20.0,50.0
5572333,1525701049,1525701060,11,168,13.142523882279795,6.0,3.0,50.0
5572334,1525701054,1525701066,12,59,14.512196311297748,6.1052709339407745,5.0,50.0
5572335,1525701059,1525701074,15,215,1.8835275108006726,2.0,1.0,4.0
5572336,1525701064,1525701082,18,89,6.53121842718679,2.0,2.0,25.417305882352913
5572337,1525701070,1525701099,29,191,10.146799306206983,5.545179672440413,3.0,50.0
5572338,1525701084,1525701118,34,231,7.9587974560565495,2.0,1.0,50.0
5572339,1525701092,1525701119,27,217,10.989726198292106,6.0,3.0,37.716293333333184
5572340,1525701099,1525701149,50,106,8.40843932444112,3.0,1.0,41.0
5572341,1525701140,1525701172,32,222,18.010268682750773,12.0,4.0,51.474286633333335
5572342,1525701168,1525701207,39,13,18.16342389611069,0.25,0.21109116141253567,91.0
5572343,1525701174,1525701207,33,251,8.895693764857905,3.626392780898294,3.0,41.0
5572344,1525701196,1525701207,11,129,14.781264852606833,7.961908653846154,5.0,50.0
5572345,1525701205,1525701216,11,196,14.988566490412053,5.0,3.0,55.48714867094407
5572346,1525701213,1525701228,15,291,5.36375901234253,1.0,1.0,39.730476014760114
5572347,1525701221,1525701229,8,136,60.76360553491095,4.0,3.0,41.0
5572348,1525701225,1525701241,16,161,7.575995212458704,3.0,1.0,20.0
5572349,1525701231,1525701267,36,157,6.993359453462885,2.0,2.0,46.959956595941854
5572350,1525701264,1525701281,17,168,14.165840726860909,10.0,4.0,50.0
5572351,1525701270,1525701288,18,96,5.17438721817732,4.0,1.8377283990147784,9.50928474929326
5572352,1525701280,1525701300,20,107,11.90342362020495,6.0,5.0,50.0
5572353,1525701298,1525701328,30,172,11.553818040843051,5.0,3.0,50.0
5572354,1525701326,1525701364,38,162,15.11361039082246,10.0,5.0,50.0
5572355,1525701363,1525701373,10,153,20.23236745762778,12.0,5.6875,56.34584725612063
5572356,1525701367,1525701382,15,100,8.018473535730907,5.0,4.0,28.418850232558125
5572357,1525701379,1525701393,14,161,9.361593928808134,5.0,3.0,31.807633333333175
5572358,1525701391,1525701412,21,90,6.870382193506052,2.207605721535065,2.0,23.476714814814795
5572359,1525701404,1525701419,15,163,15.241282984122291,5.376075055947667,3.0,50.0
5572360,1525701418,1525701432,14,84,11.350571944464377,5.0,3.0,50.0
5572361,1525701430,1525701449,19,257,6.496331934486542,3.0,1.0,30.0
5572362,1525701449,1525701470,21,205,10.402119741821624,5.0,3.0,39.63239538466371
5572363,1525701470,1525701507,37,179,22.9800103908047,11.0,4.0,61.0
5572364,1525701504,1525701530,26,239,17.22523215935371,10.025651337716068,4.0,55.3643988494983
5572365,1525701529,1525701554,25,121,15.102222987883,7.683043115161458,5.0,50.0
5572366,1525701554,1525701573,19,11,43.079395203385886,50.0,1.0,87.39139937499999
5572367,1525701572,1525701594,22,145,18.16152485684475,12.0,5.336697262065889,50.97390277770072
5572368,1525701593,1525701610,17,244,11.137183238967095,1.0,1.0,50.0
5572369,1525701608,1525701629,21,216,10.948985081978751,5.0,1.0,50.0
5572370,1525701626,1525701646,20,117,12.155291754504704,5.0,1.0,50.0
5572371,1525701645,1525701667,22,188,21.42474954729955,15.0,5.0,58.69702403675846
5572372,1525701669,1525701679,10,113,25.349088327424834,20.0,0.0,50.0
5572373,1525701678,1525701688,10,243,14.389906409487375,5.5,1.0,66.49320302122116
5572374,1525701682,1525701705,23,133,4.504003887961403,4.0,4.0,5.9886624436613
5572375,1525701698,1525701712,14,127,10.78744238343978,5.5,4.0,41.0
5572376,1525701707,1525701766,59,341,11.1298956806692,5.5,5.5,50.0
5572377,1525701764,1525701777,13,233,28.50868581268458,21.0,1.0,80.0
5572378,1525701776,1525701784,8,199,23.503645855208802,12.00499276096388,5.5,50.0
5572379,1525701783,1525701792,9,189,7.450893072628917,5.0,4.0,16.560522522522405
5572380,1525701788,1525701801,13,351,10.347187483614839,5.5,5.5,50.0
5572381,1525701798,1525701809,11,135,7.573044174044345,5.0,4.0,40.0
5572382,1525701806,1525701815,9,75,10.015014210763963,5.5,4.0,25.0
5572383,1525701809,1525701836,27,30,6.5945701112539865,4.0,4.0,32.64869129248685
5572384,1525701834,1525701860,26,219,7.318868383740563,4.0,4.0,40.0
5572385,1525701858,1525701870,12,209,12.47468046451553,5.0,3.0,50.0
5572386,1525701866,1525701884,18,134,9.152296779660864,5.0,3.0,50.0
5572387,1525701875,1525701893,18,261,11.021414175382263,5.5,5.0,40.0
5572388,1525701888,1525701901,13,255,17.43871748683537,15.0,5.5,50.0
5572389,1525701895,1525701910,15,285,7.7074781951997755,4.0,3.0,15.8374968057266
5572390,1525701906,1525701917,11,165,6.596899539776492,4.771182970741351,3.0,20.0
5572391,1525701915,1525701919,4,190,10.036110028864517,3.0,3.0,41.0
5572392,1525701918,1525701926,8,105,21.180475228500427,5.5762536646825565,5.5,60.0
5572393,1525701921,1525701939,18,279,3.6263642815523145,3.0,3.0,6.041839480158727
5572394,1525701923,1525701958,35,54,8.06680844194742,4.0,4.0,29.114732222222212
5572395,1525701953,1525701967,14,200,10.481983897903875,5.247596502994012,3.0,41.0
5572396,1525701963,1525701974,11,154,29.99707794457988,12.745874999999998,4.0,113.0
5572397,1525701971,1525702003,32,85,8.637178068045454,5.0,3.0,42.947923194458376
5572398,1525701998,1525702012,14,225,13.32125203288037,3.0,1.0,52.70254941027606
5572399,1525702008,1525702029,21,113,28.596969940494212,20.0,0.0,60.0
5572400,1525702026,1525702039,13,177,9.770431829962648,6.0,4.0,46.88120114328987
5572401,1525702031,1525702039,8,133,6.203046153324923,5.0,3.0,9.028538666666655
5572402,1525702035,1525702046,11,24,35.00951186849792,28.0,20.03832915391798,61.514273653379846
5572403,1525702044,1525702054,10,308,2.9603101523085744,3.0,1.0,7.624811773584903
5572404,1525702049,1525702071,22,100,12.016117330806878,7.0,3.0,53.06551561082211
5572405,1525702069,1525702081,12,170,9.628992994150208,4.0,1.0,50.0
5572406,1525702078,1525702097,19,162,6.300241098059264,3.0,1.0,24.142109935792245
5572407,1525702087,1525702119,32,151,7.196686151710393,2.5,2.002,26.360573809523746
5572408,1525702115,1525702137,22,157,14.319472446691183,6.0,4.0,50.0
5572409,1525702137,1525702148,11,217,27.72889557460857,20.403988246816844,5.52,56.0
5572410,1525702147,1525702157,10,77,9.74807728378806,5.000000000653392,5.0,26.828516666666623
5572411,1525702153,1525702165,12,111,7.344014679836577,4.911019200511383,3.0,20.0
5572412,1525702160,1525702177,17,184,11.519334722824814,4.0,2.5498100000000017,56.0
5572413,1525702175,1525702229,54,283,8.353210863419527,2.962092635420357,1.0,50.0
5572414,1525702226,1525702237,11,165,21.337814367953726,12.0,5.0,59.787206660137116
5572415,1525702232,1525702246,14,79,8.963049610019166,5.0,5.0,34.4696402264091
5572416,1525702242,1525702263,21,123,12.202958747307974,5.0,3.1866778499596795,50.0
5572417,1525702263,1525702296,33,148,43.39403008006227,50.0,20.0,56.0
5572418,1525702296,1525702317,21,187,16.081972859099338,8.0,5.0,60.181655729676784
5572419,1525702308,1525702317,9,124,7.240150877198407,2.002,2.0,42.67828479999992
5572420,1525702312,1525702328,16,75,5.817777197779983,5.0,4.0,10.039629310344786
5572421,1525702327,1525702337,10,163,9.90865121131014,5.0,4.0,50.0
5572422,1525702336,1525702356,20,119,9.038067004713593,5.52,3.0,28.0
5572423,1525702346,1525702363,17,195,8.93580223958458,3.0,3.0,41.0
5572424,1525702358,1525702375,17,185,10.518543911250234,5.0,3.0,51.9
5572425,1525702374,1525702384,10,140,10.765933293335044,5.0,2.5625,50.0
5572426,1525702383,1525702402,19,146,17.696366996992847,5.0,3.0,57.43655497074109
5572427,1525702395,1525702434,39,128,9.444294111321659,5.0,3.0,50.0
5572428,1525702435,1525702459,24,88,43.832599878853905,41.0,21.0,69.27886190476183
5572429,1525702453,1525702480,27,160,8.806151594176985,6.0,5.0,14.191218749999978
5572430,1525702478,1525702494,16,188,13.23447498646702,5.0,4.0,51.77656039482736
5572431,1525702494,1525702518,24,108,15.453237678443747,20.0,5.0,20.0
5572432,1525702517,1525702571,54,160,15.973660271228214,20.0,4.0,50.0
5572433,1525702570,1525702579,9,176,23.30762167914513,12.119802098765431,5.0,60.0
5572434,1525702577,1525702587,10,309,7.054256139698741,1.0,1.0,50.0
5572435,1525702586,1525702612,26,212,27.837428726122738,20.0,6.0,56.67641411549036
5572436,1525702611,1525702621,10,94,18.30062108827264,12.0,5.519522772603441,50.306441788610016
5572437,1525702617,1525702628,11,58,8.62895763553958,5.0,5.0,41.0
5572438,1525702625,1525702644,19,184,11.790984820943546,5.0,1.0,51.9
5572439,1525702630,1525702653,23,155,6.76405784084948,5.0,4.0,14.831134117647053
5572440,1525702649,1525702664,15,53,58.10961813831563,51.9,34.00696628285598,113.0
5572441,1525702663,1525702672,9,152,9.726018915139855,6.0,4.0,25.0
5572442,1525702667,1525702690,23,169,5.923543723373818,4.0,3.0,21.794738095237967
5572443,1525702675,1525702698,23,83,9.923682683685081,4.748249263157895,4.0,41.0
5572444,1525702688,1525702698,10,36,42.73971640977735,30.0,20.0,113.0
5572445,1525702694,1525702710,16,168,7.488424825131939,5.0,1.0,17.0
5572446,1525702709,1525702718,9,213,12.238684977210541,5.0,3.0,51.649128642533924
5572447,1525702715,1525702733,18,168,9.138116296162046,4.0,3.0,50.0
5572448,1525702729,1525702742,13,105,8.748172661628338,5.1,2.5625,30.0
5572449,1525702742,1525702777,35,90,3.9384195844017134,2.9567412604580223,2.0013625432121622,9.044773749999976
5572450,1525702770,1525702787,17,208,16.172392280957194,12.0,1.0,42.0
5572451,1525702781,1525702787,6,89,12.643396160145414,5.0,4.0,50.0
5572452,1525702785,1525702795,10,120,6.089925105975079,3.0,2.0,10.062615061817512
5572453,1525702791,1525702813,22,135,5.97563550705636,2.0000000018588437,2.0,29.88527138047138
5572454,1525702809,1525702823,14,217,14.22532318186936,7.6962863636363625,3.0,50.0
5572455,1525702819,1525702830,11,64,16.67919418730662,7.753785387122012,4.0,64.69942049685976
5572456,1525702828,1525702850,22,111,4.005381520376233,2.0,2.0,13.992257029181781
5572457,1525702845,1525702859,14,173,12.685353739361933,5.411761664,3.0,50.0
5572458,1525702852,1525702887,35,12,27.360231888015253,37.74304997973558,2.4943712250211894,55.07559228932372
5572459,1525702887,1525702902,15,178,15.53908752198997,11.946747646079698,5.07,49.173377005798756
5572460,1525702901,1525702913,12,148,16.705739030635744,5.764512127428341,4.411345194010626,50.0
5572461,1525702910,1525702934,24,103,9.638731797997576,5.0,4.0,40.75495206625056
5572462,1525702933,1525702960,27,222,13.056445926147891,6.0,1.0,50.0
5572463,1525702959,1525702968,9,115,12.39455477842922,5.0,4.0,53.325186104934836
5572464,1525702963,1525702997,34,131,5.991097185567025,4.0,2.318526727288976,9.948808222222212
5572465,1525702997,1525703022,25,234,32.09620249326022,33.67624411764703,8.0,51.9
5572466,1525703018,1525703034,16,177,12.07450153322298,6.0,1.0,44.44570463632707
5572467,1525703032,1525703042,10,102,9.060839351129337,5.0,4.0,41.0
5572468,1525703041,1525703053,12,26,49.57042098615634,50.0,41.0,80.0
5572469,1525703052,1525703061,9,137,8.661055946328739,5.312313090211132,3.0,25.679069254618067
5572470,1525703058,1525703069,11,107,5.46640784879992,3.0,2.0,21.195594973715988
5572471,1525703063,1525703079,16,102,11.153814659243473,6.0,4.5,56.0
5572472,1525703066,1525703095,29,145,3.145708296505295,3.0,2.0,6.148462613632667
5572473,1525703093,1525703120,27,74,55.21639952461262,50.0,41.0,97.61177907293037
5572474,1525703120,1525703133,13,199,10.945258379910205,7.569515706916668,5.3,30.0
5572475,1525703132,1525703150,18,222,6.881694579270371,4.0,1.0,20.0
5572476,1525703143,1525703164,21,230,7.3148800978645845,3.0,3.0,21.230188823289854
5572477,1525703164,1525703229,65,262,8.235529729315603,3.5763425288475355,3.0,41.0
5572478,1525703229,1525703247,18,244,39.93131797358577,30.0,10.0,113.1
5572479,1525703239,1525703256,17,131,9.889315082925272,6.0,5.0,20.0
5572480,1525703250,1525703264,14,196,12.064585688143442,5.1,4.0,50.0
5572481,1525703258,1525703273,15,66,7.979756302380147,5.0,4.0,12.666068417977023
5572482,1525703264,1525703282,18,325,5.275331819652004,3.0,1.0,34.45040917226199
5572483,1525703281,1525703324,43,168,25.86668632299496,15.110935351388889,5.1451225,51.477130270270216
5572484,1525703324,1525703341,17,165,44.83301227857262,50.0,20.0,90.16083165354894
5572485,1525703341,1525703389,48,234,11.086966664556947,7.66986762793996,1.0,39.65520540540532
5572486,1525703388,1525703398,10,200,35.616624313883364,50.0,8.1784739,56.1
5572487,1525703393,1525703427,34,78,5.8523727452418495,5.0,5.0,5.5124480760055015
5572488,1525703420,1525703436,16,167,14.266239923851415,10.0,5.0,44.80040826446273
5572489,1525703435,1525703448,13,174,9.374087348030134,5.0,4.0,41.0
5572490,1525703446,1525703457,11,176,7.300452754089941,4.0,4.0,12.469871716049383
5572491,1525703449,1525703465,16,130,5.522284744283467,4.0,3.0,6.001693394019307
5572492,1525703461,1525703478,17,200,10.512254876689866,5.0,3.0,49.08702079364598
5572493,1525703477,1525703487,10,91,12.946683632670275,5.0,2.3220509090909114,50.0
5572494,1525703484,1525703495,11,248,7.016019340759604,3.0,3.0,35.88695605579017
5572495,1525703488,1525703497,9,110,17.45074562329349,8.5,3.0,50.0
5572496,1525703490,1525703529,39,29,15.021059595542335,4.060581268592738,2.0013802236597615,50.0
5572497,1525703528,1525703544,16,218,12.369162397573112,7.0,3.0,50.0
5572498,1525703543,1525703552,9,155,13.906861732290428,5.0,3.0,50.07107281070554
5572499,1525703548,1525703560,12,81,9.890328807274523,5.0,2.5625,50.0
5572500,1525703551,1525703560,9,81,4.247473592399347,3.0,2.002,15.681771304347816
5572501,1525703556,1525703577,21,183,17.361473569009235,6.0,3.0,50.0
5572502,1525703570,1525703594,24,145,9.983987466463585,5.0,1.0,50.0
5572503,1525703589,1525703594,5,74,35.78607635194865,30.0,20.0,64.77383051359513
5572504,1525703592,1525703608,16,114,5.445277436707096,5.0,2.0,10.0
5572505,1525703595,1525703634,39,139,4.719030433658522,2.0,1.613952583668223,15.691910867943292
5572506,1525703636,1525703644,8,196,24.338209266756085,10.0,1.0,58.65094001534895
5572507,1525703641,1525703655,14,130,11.602966566125797,5.43449895635083,5.0,50.0
5572508,1525703655,1525703674,19,206,18.585310482789694,7.0,4.0,90.0
5572509,1525703671,1525703724,53,190,12.825015250021734,7.0,5.0,49.26563074999999
5572510,1525703723,1525703732,9,169,16.93212815336433,11.484241476262463,5.02,50.0
5572511,1525703727,1525703742,15,196,17.446030121944297,6.0,5.0,50.0
5572512,1525703730,1525703751,21,98,5.632139682219431,5.013346721622558,3.0,9.365194773722628
5572513,1525703739,1525703752,13,220,2.6940207382876666,3.0,1.0,4.0
5572514,1525703745,1525703762,17,294,4.607205160749014,1.0,1.0,10.034057271206086
5572515,1525703752,1525703770,18,124,8.433863845305511,5.234243975433255,2.2,21.87068124999997
5572516,1525703764,1525703778,14,96,9.559424047176105,6.0,1.0,41.82394736842104
5572517,1525703771,1525703787,16,65,6.395211439826366,5.0,2.0,20.0
5572518,1525703779,1525703796,17,90,14.373680095229833,6.0,4.0,50.0
5572519,1525703784,1525703803,19,81,12.511661025040025,10.743354259169545,4.125,40.99291678072817
5572520,1525703798,1525703810,12,167,7.838318083797115,5.0,2.5,28.923156370249025
5572521,1525703803,1525703835,32,144,3.8499252438008957,2.0,1.5,7.393063695652171
5572522,1525703831,1525703846,15,191,15.651940795483915,7.0,4.0,50.0
5572523,1525703846,1525703870,24,137,8.133602653641912,5.6973281040398245,2.0,41.0
5572524,1525703863,1525703900,37,156,10.153406206616996,4.0,4.0,49.0129916976208
5572525,1525703889,1525703924,35,204,22.124122072216224,12.0,5.0,50.0
5572526,1525703917,1525703932,15,160,9.208152644331832,6.0,4.0,26.25532432432429
5572527,1525703925,1525703942,17,133,8.833768208950076,5.0,4.0,30.0
5572528,1525703932,1525703963,31,138,7.038381375114648,5.0,4.0,15.144257550418098
5572529,1525703963,1525703979,16,180,20.55074882778371,10.0,5.0,57.9995868010999
5572530,1525703965,1525703989,24,15,7.935223987667495,7.847389723519758,5.0,8.0
5572531,1525703982,1525703998,16,219,23.842989546085434,11.99017542787286,5.0,50.0
5572532,1525703996,1525704019,23,158,9.2328303012221,5.0,4.0,50.0
5572533,1525704016,1525704028,12,127,9.20169567834974,6.0,4.0,41.0
5572534,1525704021,1525704038,17,90,11.869838158254977,4.0,2.687218772306665,57.44088368050494
5572535,1525704025,1525704046,21,17,33.54389463289712,28.0,20.0,69.94758429752059
5572536,1525704028,1525704054,26,151,5.636897654022618,5.0,4.0,8.011435019999999
5572537,1525704045,1525704054,9,40,42.0750517183109,41.0,20.0,91.15185889401508
5572538,1525704049,1525704070,21,120,7.530100150624513,6.0,4.0,15.191524389795918
5572539,1525704053,1525704071,18,129,4.685200551920759,4.0,1.0,5.0
5572540,1525704057,1525704080,23,117,5.756860523413524,4.0,4.0,8.0
5572541,1525704060,1525704102,42,9,7.707614689663264,7.685393258426966,4.0,8.0
5572542,1525704094,1525704110,16,189,16.202055365103355,10.0,1.7276640106501737,54.51865101408483
5572543,1525704099,1525704128,29,55,21.51797600249768,6.7071424242424245,1.0,91.18731739130433
5572544,1525704127,1525704147,20,183,17.091383594913047,6.0,1.0,50.02557108815283
5572545,1525704141,1525704156,15,172,13.52006850187255,5.960510158490566,1.0,55.853972307692295
5572546,1525704146,1525704165,19,182,17.102828373311848,6.0,4.0,50.0
5572547,1525704161,1525704174,13,49,28.763709198441628,14.375570808907403,12.0,90.0
5572548,1525704165,1525704199,34,73,44.319366110575295,50.0,14.156710282612888,92.76511739130433
5572549,1525704193,1525704261,68,172,11.315111175921638,6.0,4.0,50.0
5572550,1525704253,1525704271,18,211,27.779477669526948,20.0,1.0,64.16121626771908
5572551,1525704260,1525704271,11,173,14.211178621718814,6.0,5.0,50.0
5572552,1525704267,1525704285,18,93,8.854109417729926,5.0,4.0,36.296596212850986
5572553,1525704281,1525704295,14,38,25.497343176628803,13.430873372751664,12.0,53.599613711340204
5572554,1525704294,1525704318,24,184,12.554129450835166,6.0,4.0,50.0
5572555,1525704314,1525704340,26,179,17.235649385300405,12.0,4.0,50.0
5572556,1525704340,1525704365,25,127,15.030365903146826,6.0,4.0,50.0
5572557,1525704364,1525704377,13,173,15.371606691682015,7.172188744,4.0,50.0
5572558,1525704373,1525704406,33,141,13.28413926373544,6.0,4.0,50.0
5572559,1525704409,1525704423,14,175,28.69129008994017,20.0,4.0,76.63433216991568
5572560,1525704422,1525704444,22,34,12.567537016894073,6.244389571620334,5.204262582307187,50.0
5572561,1525704444,1525704452,8,216,40.92164104060173,50.0,15.0,53.91344516129031
5572562,1525704449,1525704486,37,197,14.41215948141293,15.0,7.0,25.48402171089304
5572563,1525704486,1525704512,26,232,24.23648763595643,20.0,1.0,50.03537401895923
5572564,1525704511,1525704521,10,155,20.390536302729107,10.376018133333332,5.3,50.0
5572565,1525704522,1525704536,14,219,10.849381469540615,5.278647520859845,1.0,50.0
5572566,1525704528,1525704536,8,183,18.668764467537375,6.0,5.0,56.1
5572567,1525704533,1525704563,30,120,5.267003130509887,4.91746289566175,4.0,9.125547766423358
5572568,1525704565,1525704614,49,171,27.911754595191535,20.519852,6.0,52.03255752895752
5572569,1525704615,1525704643,28,194,39.071780447598414,50.0,10.0,56.21
5572570,1525704643,1525704681,38,318,11.664962422226433,1.0,1.0,56.60907363013697
5572571,1525704682,1525704697,15,221,40.228680218603216,40.0,12.0,80.36254636790142
5572572,1525704696,1525704708,12,151,11.755171423231475,6.0,5.3,26.45412739439112
5572573,1525704704,1525704715,11,133,9.637574683694014,5.3,5.019402776190476,34.682266776790726
5572574,1525704709,1525704724,15,267,6.9570774474282295,1.0,1.0,53.19358178256609
5572575,1525704716,1525704725,9,173,11.848979433133286,5.763266595081878,5.0,50.0
5572576,1525704721,1525704742,21,148,8.769214827427797,5.0,4.0,21.0
5572577,1525704736,1525704750,14,180,17.909890679506052,6.968013157894742,5.0,50.0
5572578,1525704741,1525704770,29,146,7.510806284245675,5.21,3.462196955067692,17.515088843488588
5572579,1525704766,1525704789,23,203,15.489256861135333,6.0,5.0,50.0
5572580,1525704783,1525704791,8,109,13.822259093268874,6.0,5.0,50.0
5572581,1525704787,1525704809,22,140,8.665204371447592,5.0,5.0,14.894560155848591
5572582,1525704805,1525704823,18,219,19.2926187854624,10.890315589051964,5.0,56.285074432
5572583,1525704821,1525704833,12,192,11.126602574482309,5.3,5.0,50.0
5572584,1525704831,1525704850,19,86,7.411578080561975,4.575288124999999,4.0,15.457957066730767
5572585,1525704846,1525704865,19,142,11.535392115964713,5.8795618704239185,3.34375,50.0
5572586,1525704862,1525704874,12,19,15.659520997397049,14.003133695240502,8.0,50.0
5572587,1525704867,1525704884,17,166,13.09111536072724,6.0,4.0,50.0
5572588,1525704874,1525704896,22,137,7.342859766263678,3.9982792857142857,3.0,43.01773769010427
5572589,1525704897,1525704925,28,219,21.221724914761094,10.57806322887743,5.3,50.0
5572590,1525704924,1525704956,32,160,14.312409636124858,6.0,4.0,50.0
5572591,1525704958,1525704966,8,179,17.25081784632459,6.0,3.562454007367807,51.53040456521738
5572592,1525704963,1525704974,11,145,13.25552277682407,5.3,4.0,85.84648554651825
5572593,1525704968,1525704975,7,86,31.574830529368377,28.0,4.304275025248088,50.0
5572594,1525704971,1525704984,13,185,4.129408622336835,3.0,3.0,7.661069554140125
5572595,1525704977,1525705049,72,200,10.445499236323137,6.0,4.0,31.98602640267733
5572596,1525705047,1525705058,11,223,23.246047314133932,20.0,6.0,58.86950154463682
5572597,1525705051,1525705076,25,89,5.902348483594809,5.543613253532003,4.125,6.231905532864266
5572598,1525705068,1525705084,16,179,17.73392283227984,15.0,5.0,50.0
5572599,1525705080,1525705103,23,149,9.491057717642182,6.0,1.0,39.86798603395061
5572600,1525705100,1525705119,19,260,16.517718645971883,6.0,1.0,59.85181603248843
5572601,1525705121,1525705146,25,111,11.494841708882074,6.0,4.0,50.0
5572602,1525705145,1525705172,27,146,19.803190441480332,10.093540868915202,5.0,50.0
5572603,1525705171,1525705193,22,218,15.331235149481996,6.993311,1.0,50.0
5572604,1525705191,1525705202,11,191,10.66348152795671,5.0,4.0,50.0
5572605,1525705200,1525705211,11,154,7.717197622575728,3.684559999999999,3.0,50.0
5572606,1525705211,1525705222,11,236,28.492879036540007,20.0,6.0,100.0
5572607,1525705219,1525705238,19,111,6.814705349337854,5.011802029967587,3.0,20.0
5572608,1525705223,1525705238,15,158,4.121049053714633,3.0,3.0,6.0
5572609,1525705228,1525705277,49,237,5.160145265690183,3.0,3.0,20.0
5572610,1525705275,1525705291,16,317,10.617989169471368,1.0,1.0,50.0
5572611,1525705292,1525705309,17,165,16.275437043420236,16.0,6.0,53.19473135999999
5572612,1525705309,1525705319,10,177,10.431189863280009,6.0,4.0,40.0
5572613,1525705314,1525705327,13,97,5.126485451738052,4.0,2.98701809475061,7.971069718309833
5572614,1525705317,1525705355,38,138,8.560022136049854,2.5460303591915983,2.002,41.0
5572615,1525705354,1525705363,9,219,16.25763661545588,6.46875,4.0,50.0
5572616,1525705357,1525705371,14,183,10.280278651658218,6.0,1.0,49.872669980621815
5572617,1525705368,1525705379,11,130,15.25817765876962,9.0,4.0,50.0
5572618,1525705373,1525705388,15,157,14.613519383892337,6.0,3.0,50.0
5572619,1525705387,1525705416,29,170,11.934583788826398,6.0,3.0,50.0
5572620,1525705414,1525705435,21,129,17.135841696682306,8.021845013297872,1.0,50.0
5572621,1525705430,1525705444,14,154,9.419680775287265,5.32215203988772,4.0,34.01458664314516
5572622,1525705435,1525705452,17,98,6.362808585915224,3.0,2.002,35.328877777777684
5572623,1525705445,1525705483,38,143,12.715366090448724,6.0,4.0,50.0
5572624,1525705481,1525705504,23,149,11.746143021388786,6.0,4.0,41.0
5572625,1525705502,1525705525,23,138,8.891754416219614,6.0,3.0,41.0
5572626,1525705523,1525705540,17,131,8.56417595478116,5.0,2.002,26.0
5572627,1525705537,1525705553,16,155,7.722372175401747,6.0,2.0,26.0
5572628,1525705542,1525705560,18,13,50.21052505407881,41.0,2.11,158.84314166538576
5572629,1525705545,1525705567,22,117,6.508753905151307,6.0,2.0,20.0
5572630,1525705557,1525705575,18,81,11.113712631522308,9.23507845851957,3.0,38.88469154166666
5572631,1525705574,1525705586,12,76,28.621427934821153,20.0,15.0,50.0
5572632,1525705585,1525705604,19,143,9.892703705623312,6.0,4.0,50.0
5572633,1525705594,1525705612,18,66,6.094468126420321,5.0,2.0,14.775864899130685
5572634,1525705598,1525705634,36,94,5.263366655143158,6.0,2.0,10.0
5572635,1525705631,1525705653,22,219,12.34457501826463,6.0,1.0,50.0
5572636,1525705650,1525705664,14,147,12.245376610114015,6.0,4.125,50.0
5572637,1525705661,1525705672,11,139,12.438441790993885,6.0027029086057455,4.0,50.0
5572638,1525705668,1525705697,29,49,7.198420043023847,5.0,3.6087837730496455,27.47957504284657
5572639,1525705691,1525705726,35,122,22.058210317732087,10.0,6.0,90.0
5572640,1525705725,1525705735,10,105,20.366860755577967,10.0,6.0,60.504312
5572641,1525705729,1525705751,22,177,21.972094959094928,9.0,5.072075571428571,50.0
5572642,1525705739,1525705760,21,50,6.601244785629534,5.309249177919011,5.0,14.018528239202652
5572643,1525705746,1525705761,15,270,3.3397844769173815,3.0,1.0,7.46169605893288
5572644,1525705751,1525705782,31,118,9.127311224428514,5.016004746189638,3.0,41.0
5572645,1525705764,1525705782,18,126,14.129951598321691,6.0,4.0,57.0
5572646,1525705768,1525705803,35,324,3.9732127676664186,3.0,3.0,4.0
5572647,1525705798,1525705812,14,112,25.402770916223414,15.0,6.8480498227252316,57.0
5572648,1525705806,1525705822,16,135,6.291796697930254,5.0,3.0,8.96890377046216
5572649,1525705818,1525705840,22,224,10.516764548870364,5.043694233333333,3.0,50.0
5572650,1525705830,1525705856,26,296,5.491731609831143,3.0,3.0,20.0
5572651,1525705855,1525705876,21,123,22.660693555586224,13.031370265151516,6.227311142857143,62.94175777777777
5572652,1525705874,1525705886,12,125,8.87297743408059,6.0,4.0,30.0
5572653,1525705880,1525705895,15,57,37.559686239082204,41.0,20.0,50.17034060558408
5572654,1525705889,1525705922,33,35,4.432656649986979,0.0,0.0,50.0
5572655,1525705914,1525705980,66,93,21.033538324784686,10.0,8.0,51.41353763888888
5572656,1525705979,1525706004,25,219,16.822949639319834,8.0,6.0,50.067896450720816
5572657,1525706002,1525706013,11,113,46.152907731411844,50.0,20.0,114.0
5572658,1525706007,1525706024,17,66,8.693675118516458,8.550644952380953,6.0,12.59123351844506
5572659,1525706014,1525706024,10,76,15.319737406962048,10.0,8.0,50.0
5572660,1525706020,1525706035,15,184,5.4451191553460765,5.392161489576839,1.0,8.592857729063319
5572661,1525706030,1525706091,61,111,10.256579872339719,5.0,4.0,49.81697395983497
5572662,1525706089,1525706100,11,206,20.3936341831137,10.0,1.0,66.9839597402597
5572663,1525706098,1525706143,45,79,13.211154783116767,10.0,6.0,43.84442402227341
5572664,1525706142,1525706151,9,186,16.56590767876368,9.967418369499999,6.0,50.0
5572665,1525706147,1525706161,14,242,4.858676509968726,1.0,1.0,25.24303247232469
5572666,1525706151,1525706168,17,63,10.296210297114866,10.0,1.0,28.0
5572667,1525706160,1525706178,18,167,6.292227896668204,5.0,4.0,11.940740078414617
5572668,1525706177,1525706190,13,143,14.082554544635983,10.0,1.0,50.0
5572669,1525706181,1525706199,18,110,2.1973466265316737,1.0,1.0,5.0
5572670,1525706191,1525706230,39,163,7.226363057695556,5.0,3.0,29.98522459800862
5572671,1525706223,1525706241,18,143,12.699688031514158,6.0,4.517936016918301,50.0
5572672,1525706233,1525706249,16,96,37.20547023999562,28.0,15.0,82.10525512195119
5572673,1525706242,1525706267,25,105,5.832244584971519,5.0,1.0,10.00824724308241
5572674,1525706266,1525706276,10,203,18.89571636399794,8.0,5.6875,50.0
5572675,1525706275,1525706294,19,161,7.785818193666471,5.820611449023502,4.0,22.0
5572676,1525706283,1525706315,32,187,5.198763439558335,3.1293583456311183,1.0,18.69571030198198
5572677,1525706314,1525706325,11,192,13.294193518872087,6.0,3.0,47.06286162361621
5572678,1525706320,1525706334,14,162,14.383110366792046,6.0,1.0,50.0
5572679,1525706334,1525706351,17,168,9.150902445780195,6.0,3.0,30.0
5572680,1525706341,1525706352,11,68,7.117700678686284,5.062377800440405,1.0,27.497637065637065
5572681,1525706348,1525706379,31,28,45.503941254809114,50.0,20.614916127688925,69.95551999999999
5572682,1525706379,1525706393,14,197,16.135010952497392,7.62271538461539,4.833163664064742,50.0
5572683,1525706393,1525706410,17,9,65.85204558898634,52.701910423954615,49.1955216374269,91.0
5572684,1525706403,1525706420,17,141,10.496664289490989,6.0,4.0,46.431424361959884
5572685,1525706410,1525706429,19,222,20.60845240207358,9.0,3.0,50.44825939999999
5572686,1525706420,1525706437,17,161,7.460959978742367,3.0,2.0,55.940972502291466
5572687,1525706438,1525706460,22,163,11.668721834751265,6.0,3.0,57.28171438508516
5572688,1525706460,1525706470,10,152,10.573783899248664,6.0,3.0,41.0
5572689,1525706462,1525706470,8,40,10.377202085868422,5.0,4.029259521687572,50.0
5572690,1525706464,1525706500,36,8,7.5731957932156,7.534600429238733,3.0,8.0
5572691,1525706489,1525706501,12,153,11.20780516154814,6.0,3.0,41.0
5572692,1525706492,1525706514,22,54,3.1540723409832334,3.0,2.84375,5.0071452049886505
5572693,1525706495,1525706516,21,114,3.727364631724888,2.0,2.0,14.921246042992848
5572694,1525706505,1525706533,28,73,2.6013562211784182,2.0,2.0,3.552244984216883
5572695,1525706534,1525706548,14,169,22.379825248771038,9.0,5.989832588638589,80.99093286079821
5572696,1525706546,1525706558,12,158,8.681284682852983,5.0,3.0,50.0
5572697,1525706553,1525706576,23,76,3.9973689705408537,3.0,2.0,15.361821416666645
5572698,1525706576,1525706590,14,163,13.401395557858828,6.0,2.0747770588235293,50.0
5572699,1525706589,1525706603,14,176,7.630676436016213,2.0,1.5565652573529412,41.0
5572700,1525706600,1525706614,14,144,11.415668332065172,5.5502394935706505,1.0,56.59412578124998
5572701,1525706613,1525706627,14,155,10.176278764310506,6.0,3.0,40.6701823559983
5572702,1525706620,1525706635,15,142,3.892644040998793,2.0,1.0,10.0
5572703,1525706630,1525706647,17,157,5.762823922726491,3.0,1.5,20.098988888888886
5572704,1525706645,1525706665,20,142,17.724596039479305,10.0,4.0,50.0
5572705,1525706657,1525706665,8,135,13.711358271918227,6.0,2.2,57.0
5572706,1525706661,1525706674,13,37,21.13196063356816,6.0,4.412801909090909,57.0
5572707,1525706669,1525706683,14,95,5.955768093706306,2.0,2.0,20.0
5572708,1525706682,1525706703,21,226,8.310317734781263,4.331608125661181,1.0,41.0
5572709,1525706698,1525706713,15,139,7.8681954687766655,4.0,1.345399615735494,40.0
5572710,1525706712,1525706725,13,188,8.1763692838136,6.0,3.0,30.0
5572711,1525706726,1525706733,7,116,8.806517937666923,4.0,1.2945632624809107,50.0
5572712,1525706731,1525706742,11,185,21.952882985874112,8.0,3.0,50.0
5572713,1525706742,1525706769,27,18,53.48307424600673,50.0,20.0,111.1893918367347
5572714,1525706764,1525706770,6,166,10.819384708655093,6.0,3.34375,48.9685025625
5572715,1525706766,1525706770,4,19,52.00250200460447,50.0,24.95180139686052,100.0
5572716,1525706768,1525706785,17,234,5.028580534157099,2.5980373364825575,1.0,25.11232176470586
5572717,1525706774,1525706794,20,76,5.196381880901558,2.0,2.0,18.55121526935749
5572718,1525706783,1525706794,11,165,27.573130063378102,26.0,1.0,50.0
5572719,1525706790,1525706804,14,124,4.896462658465059,3.0,2.0,15.394826641224489
5572720,1525706797,1525706804,7,44,15.966503760845644,5.8374782546424075,1.0,50.24808770804792
5572721,1525706802,1525706872,70,13,7.81192312995246,6.0,6.0,21.689997297297296
5572722,1525706871,1525706881,10,201,25.01434201748538,15.0,1.0,90.0
5572723,1525706877,1525706889,12,105,6.597226008260688,5.92,5.0,8.016833961693548
5572724,1525706885,1525706897,12,101,15.643488053390415,1.0,1.0,84.73303298429312
5572725,1525706890,1525706919,29,201,12.334038487328904,5.0291338,4.0,50.0
5572726,1525706910,1525706928,18,180,12.549135229497098,5.0,2.0,50.0
5572727,1525706926,1525706953,27,194,14.305765510061299,5.796035693177794,1.0,50.0
5572728,1525706946,1525706955,9,130,8.184146155528877,5.0,3.0,41.0
5572729,1525706949,1525706963,14,110,4.266141833200559,3.0,2.0,8.682188571428547
5572730,1525706954,1525706994,40,132,19.073558698946215,6.0,4.0,55.3378987596189
5572731,1525706992,1525707031,39,156,8.695339727282635,5.018885999999999,2.0,41.0
5572732,1525707024,1525707031,7,201,20.326493833582063,10.0,3.0,58.19994183376448
5572733,1525707028,1525707039,11,156,11.698545574380182,5.985182055343511,3.0,50.0
5572734,1525707038,1525707070,32,95,17.534569737956854,6.0,1.0,63.20685454545434
5572735,1525707068,1525707078,10,196,11.476567674677732,6.0,3.0,48.78722422110278
5572736,1525707074,1525707088,14,54,45.20387179191949,50.0,28.0,50.0
5572737,1525707079,1525707096,17,130,4.660466283552205,3.0,2.0,11.61715122296925
5572738,1525707092,1525707108,16,172,9.078522812405977,6.0,1.0,36.64909473684191
5572739,1525707110,1525707135,25,88,5.734047515932873,3.0,1.78125,25.92
5572740,1525707135,1525707147,12,211,18.32234192985828,8.497029475025798,2.9678360000000006,51.9
5572741,1525707149,1525707155,6,45,25.321422125603235,15.0,0.0,95.30384695652174
5572742,1525707154,1525707165,11,137,11.062449341023425,5.92,3.0,50.30418222789966
5572743,1525707164,1525707193,29,96,2.7425072185342736,2.0,1.0,5.92
5572744,1525707189,1525707200,11,161,9.500894905981504,5.92,4.0,41.0
5572745,1525707196,1525707209,13,177,9.074701781876557,4.0,1.0,48.32738714968262
5572746,1525707207,1525707217,10,94,5.422392566804701,4.326650201594576,1.312306150371843,13.213169032162334
5572747,1525707211,1525707239,28,232,6.859488113959412,3.0,3.0,27.1361688888889
5572748,1525707237,1525707248,11,137,18.518492307660143,6.0,4.095939031821442,59.43767021081575
5572749,1525707244,1525707249,5,161,5.097470166964809,3.0,1.0,20.0
5572750,1525707247,1525707263,16,106,4.2488348723555545,2.0,1.0,15.10055999999994
5572751,1525707255,1525707270,15,84,6.544541058970234,5.0,1.2,20.0
5572752,1525707259,1525707278,19,202,9.252176445138181,4.0,3.0,50.0
5572753,1525707273,1525707305,32,119,12.879579932200476,5.0,1.2,60.95147330954855
5572754,1525707303,1525707350,47,223,10.74856147353513,6.0,1.2,41.571460633484136
5572755,1525707350,1525707362,12,215,24.44822059741046,20.0,5.92,60.54082810969638
5572756,1525707362,1525707371,9,188,8.571907290398991,5.92,3.0,41.0
5572757,1525707371,1525707381,10,296,5.53559287563385,1.0,1.0,40.050495519397266
5572758,1525707382,1525707389,7,119,10.823794831927547,6.0,3.0,50.0
5572759,1525707386,1525707397,11,92,4.865323615911102,2.0,1.2,16.387836512999996
5572760,1525707389,1525707406,17,176,5.858381888143095,1.429878187588123,1.0,50.0
5572761,1525707401,1525707421,20,128,21.043913226317358,12.374880774803469,4.0658729546681425,50.0
5572762,1525707417,1525707462,45,170,10.362035418895207,5.0,1.0,42.957342607347115
5572763,1525707462,1525707471,9,197,10.598036880895817,6.0,4.0,41.0
5572764,1525707464,1525707504,40,158,2.9573740334639225,2.5,1.2,8.784601136743293
5572765,1525707495,1525707504,9,187,17.51786823753565,6.0,4.0,52.048556182518915
5572766,1525707499,1525707529,30,186,12.165411207642077,5.042603958333333,2.2,50.0
5572767,1525707528,1525707537,9,194,14.718415027968076,5.721559560656489,3.0,50.0
5572768,1525707531,1525707546,15,13,8.151513535755512,7.886667730061349,3.1703783531917726,9.99614511965919
5572769,1525707538,1525707557,19,191,5.699417851464264,3.0,2.0,8.355498579999995
5572770,1525707554,1525707575,21,33,50.511132711746626,49.883845090281866,6.0,90.0
5572771,1525707568,1525707582,14,157,16.598422615469715,6.0,4.0,54.96297687087683
5572772,1525707572,1525707590,18,202,13.972064563372975,6.0,3.0,50.0
5572773,1525707585,1525707597,12,208,15.341126042801363,5.0,3.0,56.0
5572774,1525707589,1525707612,23,86,6.512437493040977,5.0,1.5,23.031469605575296
5572775,1525707603,1525707623,20,92,10.689758220793216,6.0,3.0,50.0
5572776,1525707616,1525707632,16,8,3.0313183249924256,2.0,1.4299323402219282,5.0
5572777,1525707631,1525707673,42,151,10.639086237754885,5.0,2.0,50.0
5572778,1525707671,1525707691,20,164,20.551068581084262,10.0,5.0,52.745306288659776
5572779,1525707689,1525707702,13,158,5.932165346917687,4.0,2.0,20.0
5572780,1525707691,1525707710,19,75,4.401544679138606,2.0,2.0,17.45811093530239
5572781,1525707697,1525707727,30,52,5.936232224883387,2.0,1.3091494309508898,21.772523762732604
5572782,1525707726,1525707743,17,167,10.459711659739918,5.0,1.0,50.0
5572783,1525707740,1525707796,56,143,14.294793650573327,5.824683466819222,1.2591154709815728,68.90621263636356
5572784,1525707794,1525707803,9,151,59.144613142973746,10.203141233766226,5.160306535333306,116.63398177162057
5572785,1525707799,1525707811,12,9,41.236382832803926,51.3831159577899,0.8134549292307692,91.0
5572786,1525707802,1525707818,16,279,8.314815291193955,1.0,1.0,50.0
5572787,1525707810,1525707827,17,165,6.581621019729397,5.0,3.0,15.551300685975598
5572788,1525707819,1525707843,24,179,11.29428194157192,5.0,2.0,50.0
5572789,1525707845,1525707853,8,221,9.023545330617857,5.0,1.0,41.510721740295985
5572790,1525707851,1525707866,15,166,32.03767435951127,21.0,21.0,56.0
5572791,1525707865,1525707882,17,186,7.288575155314541,5.0,1.0,20.0
5572792,1525707881,1525707892,11,136,7.2093383023017115,5.0,1.0,41.0
5572793,1525707890,1525707908,18,21,49.06032051447914,44.6094145156342,20.0,113.0
5572794,1525707892,1525707908,16,118,5.79468478203539,5.0,2.0,14.347202162162112
5572795,1525707896,1525707908,12,118,7.53618234175547,6.0,2.0,16.146430653475996
5572796,1525707905,1525707917,12,202,6.662123644523103,4.0,3.0,25.0
5572797,1525707913,1525707938,25,124,8.523408625903873,5.0,2.0,30.0
5572798,1525707936,1525707955,19,86,11.212857089478865,6.0,4.0,30.0
5572799,1525707946,1525707963,17,14,9.12204910395857,6.426354396278482,4.033029970186726,31.029407273673996
5572800,1525707948,1525707964,16,131,11.015719059364955,2.5,1.0,73.29209632008263
5572801,1525707953,1525707966,13,53,7.077849364419674,5.0,2.005265611083622,21.66879880538436
5572802,1525707959,1525707994,35,122,3.5225223538723665,1.3341704311747598,1.0,2.350996305520515
5572803,1525707983,1525707995,12,164,15.307993513594182,6.0,2.1,60.0
5572804,1525707990,1525708016,26,90,8.873895114680048,6.0,2.0,41.0
5572805,1525708008,1525708031,23,51,34.88005933860518,25.0,15.0,102.0
5572806,1525708019,1525708050,31,260,6.08483139913898,1.0,1.0,40.0
5572807,1525708026,1525708050,24,38,8.50908364887385,5.063355473270076,4.0,29.47662333333332
5572808,1525708046,1525708104,58,201,11.087151717831185,4.0,1.0,50.0
5572809,1525708103,1525708125,22,211,28.134634468622263,21.0,5.0,55.965920636494864
5572810,1525708123,1525708135,12,101,7.5256033902045205,5.078598577379893,5.0,17.648434758073922
5572811,1525708134,1525708162,28,155,8.55611401391081,4.0,3.0,40.28903261245804
5572812,1525708161,1525708180,19,152,10.973398755538938,5.0,3.7531321917808222,50.0
5572813,1525708174,1525708189,15,156,5.590245477126217,2.1,2.0,20.505476402960774
5572814,1525708184,1525708204,20,100,8.631658316925556,3.0,1.1704027399847168,50.0
5572815,1525708203,1525708247,44,183,9.062898323427099,5.019945238962095,2.0,40.847799925675815
5572816,1525708246,1525708258,12,212,16.26809588074486,8.0,1.0,50.0
5572817,1525708256,1525708275,19,118,10.107774089150883,5.0,3.0,50.0
5572818,1525708272,1525708285,13,140,10.060756630024766,5.0,2.0,45.865339799859086
5572819,1525708284,1525708299,15,133,11.993883874906755,5.0,1.1,50.0
5572820,1525708297,1525708307,10,10,17.234246837410623,8.912527835051545,2.0,50.0
5572821,1525708304,1525708320,16,100,5.337710759993367,4.71856726719586,2.0,14.028117424242307
5572822,1525708317,1525708335,18,177,17.43010877671213,8.0,4.0,50.0
5572823,1525708335,1525708343,8,96,6.700332427751526,4.104457799896293,2.0,25.971429151291503
5572824,1525708341,1525708352,11,138,13.925398746010272,5.578919288011581,3.0,51.2869343780607
5572825,1525708347,1525708373,26,69,9.575928369392042,3.0,2.0,50.0
5572826,1525708359,1525708382,23,65,5.986164688973997,4.098403582766328,1.3993985178758996,15.122324324324158
5572827,1525708377,1525708391,14,133,21.46134321316157,7.47752702702703,3.0,54.32180013749997
5572828,1525708384,1525708391,7,140,8.858061145618848,5.0,3.0,43.045022519209496
5572829,1525708388,1525708428,40,13,7.397368330674503,7.370363530967732,2.8217500799999997,8.0
5572830,1525708421,1525708438,17,177,23.205441909272935,13.889557915057914,5.0,50.0
5572831,1525708436,1525708444,8,161,7.782550006783201,5.0,3.0,32.268830407239804
5572832,1525708441,1525708452,11,108,5.933792839646194,2.5,1.0,26.333643529411766
5572833,1525708448,1525708471,23,68,6.611571371788817,4.917116108786611,2.0,15.664831011369222
5572834,1525708470,1525708484,14,150,11.278587558406233,6.0,1.0,50.0
5572835,1525708483,1525708491,8,52,52.56752596585004,50.0,49.0259008,81.60529625122999
5572836,1525708491,1525708523,32,248,8.030072646672272,4.0,1.0,30.0
5572837,1525708517,1525708566,49,173,13.128345685608151,6.0,1.0,41.0
5572838,1525708565,1525708574,9,181,13.288079212546265,10.0,3.3563354153248564,28.0
5572839,1525708571,1525708592,21,182,16.26427672218602,6.0,3.0,53.0
5572840,1525708590,1525708606,16,139,10.947917783115441,4.926524931648288,2.1,54.75534650348116
5572841,1525708605,1525708613,8,182,9.725966449420657,5.0,2.284816813094674,50.0
5572842,1525708612,1525708642,30,100,5.748994265185936,3.0,2.0,28.0
5572843,1525708645,1525708657,12,141,23.092670543620947,15.0,5.006155385904478,50.0
5572844,1525708649,1525708657,8,106,2.7272414298466923,2.1,2.0,5.0
5572845,1525708652,1525708675,23,73,3.5690220735383433,2.2411758139534883,2.0,6.599339043280181
5572846,1525708669,1525708705,36,123,7.545100616262746,2.1,2.0,50.0
5572847,1525708703,1525708724,21,168,14.087077472208215,6.0,3.0,50.0
5572848,1525708724,1525708745,21,185,17.698479509650177,10.0,3.0,53.25588140778921
5572849,1525708743,1525708781,38,171,9.9361687449454,5.0,2.1,50.0
5572850,1525708782,1525708799,17,166,26.67828209466776,20.0,5.70868483296169,57.32238077976861
5572851,1525708794,1525708816,22,168,8.01758736770022,5.0,3.0,34.292492307692235
5572852,1525708814,1525708843,29,140,10.889539070629935,5.0,2.1,50.0
5572853,1525708843,1525708882,39,140,12.19278857323346,6.025023142791021,2.1042053143896253,40.78804683301343
5572854,1525708883,1525708908,25,227,14.099519397360591,6.169551492537313,1.0,50.0
5572855,1525708908,1525708936,28,110,30.030772208397355,20.89164225441277,0.0,74.68471103179193
5572856,1525708936,1525708951,15,178,10.518579511351513,6.0,5.0,50.0
5572857,1525708951,1525708992,41,138,14.918153941054518,5.871494982798165,5.0,60.0
5572858,1525708991,1525709001,10,182,15.930811291942904,8.0,5.160576095714901,50.0
5572859,1525708997,1525709023,26,25,12.340581484949741,9.472127748196716,0.0,34.247488222222216
5572860,1525709024,1525709033,9,352,1.0728818006521919,1.0,1.0,1.0
5572861,1525709034,1525709042,8,197,16.02585587213099,7.0,5.0,50.0
5572862,1525709039,1525709042,3,0,0,0,0,0
5572863,1525709042,1525709090,48,102,6.1852605343880285,5.0,4.0,11.444815414190058
5572864,1525709090,1525709104,14,35,38.02355446354508,50.0,6.635354942540397,98.913121719457
5572865,1525709104,1525709113,9,277,8.965144571057268,1.0,1.0,41.0
5572866,1525709111,1525709143,32,137,7.350938146039742,5.0,4.0,7.9209062810604065
5572867,1525709136,1525709143,7,176,9.201738375076696,5.0,1.0,42.20631568276272
5572868,1525709141,1525709152,11,95,8.971677894072677,4.589506535947712,3.0,26.342335524256647
5572869,1525709148,1525709183,35,123,6.753839791269767,5.0,2.2,25.775263468634638
5572870,1525709180,1525709193,13,168,8.738594245948333,5.0,2.1,30.0
5572871,1525709184,1525709193,9,83,5.732557079495407,3.0,2.1,10.38104125177809
5572872,1525709187,1525709218,31,86,3.453646161183392,3.0,2.0,4.91108529281103
5572873,1525709218,1525709242,24,184,24.280075142609583,15.0,5.964917837803659,50.0
5572874,1525709240,1525709257,17,167,8.938266238966163,5.0,2.2,50.0
5572875,1525709257,1525709271,14,132,11.825345763542982,6.0,4.0,47.84826964270148
5572876,1525709266,1525709278,12,50,9.24911674774484,6.0,5.0502063945088675,15.0
5572877,1525709274,1525709280,6,127,4.234696558438729,2.2,2.0,8.867778844058726
5572878,1525709278,1525709296,18,164,3.4258515749321554,2.0,1.0,6.362942578125
5572879,1525709293,1525709325,32,92,5.036069597229569,2.0,2.0,8.0
5572880,1525709322,1525709334,12,171,13.059148001157805,5.242023841807909,2.1356333802816905,50.042010022203414
5572881,1525709328,1525709344,16,188,8.945267284589171,4.0,3.0,50.0
5572882,1525709332,1525709353,21,77,3.883712440900113,2.0,1.1,16.657092835820873
5572883,1525709345,1525709372,27,99,8.14472896601167,5.0,1.1,50.0
5572884,1525709352,1525709386,34,43,5.727364366421746,2.0,1.1,36.06214166666664
5572885,1525709355,1525709387,32,90,5.880502197048532,2.0,1.0001,22.676754038452152
5572886,1525709359,1525709387,28,10,5.239144986858671,4.0,3.0478258888365413,4.0
5572887,1525709363,1525709387,24,64,6.869586450116437,2.0,1.1398586560856412,30.463161549143354
5572888,1525709374,1525709406,32,66,49.619299240780265,50.0,42.15640255227661,50.0
5572889,1525709388,1525709413,25,190,8.350780217302411,5.000008298859116,3.0,20.0
5572890,1525709402,1525709421,19,105,8.35198223346224,2.0,1.0,50.0
5572891,1525709406,1525709421,15,76,12.799314765586017,2.0,1.225237911554833,50.0
5572892,1525709415,1525709442,27,182,12.023046155856266,6.0,1.0,41.0
5572893,1525709427,1525709442,15,95,8.870452041109143,5.0,1.336645571093061,41.0
5572894,1525709440,1525709451,11,161,11.378423407025819,5.802093423414237,2.0,50.0
5572895,1525709444,1525709459,15,97,11.619053499801968,4.0,2.0,50.0
5572896,1525709452,1525709478,26,91,4.814912720305959,2.0,2.0,20.9898641723356
5572897,1525709458,1525709478,20,25,8.809153290908236,6.0,4.049604273229282,20.353169916075274
5572898,1525709470,1525709486,16,219,6.723434055161053,2.0692355374000346,1.0,28.499337931034475
5572899,1525709474,1525709487,13,27,8.768519964155962,5.765599429722741,5.0,28.0
5572900,1525709481,1525709497,16,121,7.523567859157916,1.9908464425587469,1.0,50.0
5572901,1525709491,1525709505,14,150,10.252324207621259,2.0,1.0,50.0
5572902,1525709495,1525709506,11,138,22.36368384886069,5.0,1.0,50.0
5572903,1525709502,1525709514,12,152,7.609268150086758,3.0,2.0,50.0
5572904,1525709506,1525709529,23,206,20.650094234077432,6.0,3.0,50.0
5572905,1525709525,1525709546,21,64,17.638463295472928,3.049368831168831,1.0,50.0
5572906,1525709536,1525709554,18,200,23.033902042579374,20.0,1.0,50.0
5572907,1525709548,1525709563,15,103,9.155498928197776,5.2732493226267305,1.0,53.84959417808218
5572908,1525709554,1525709594,40,141,9.516518419539102,5.0,1.0,48.906959481235184
5572909,1525709581,1525709602,21,172,14.013375957603877,6.0,5.0,51.9
5572910,1525709601,1525709620,19,206,21.216803172189397,10.27318285602933,1.0,50.0
5572911,1525709610,1525709627,17,119,3.9338975285866113,2.0,1.0,20.0
5572912,1525709625,1525709635,10,164,11.573268292424764,6.0,2.0,50.0
5572913,1525709629,1525709667,38,57,7.558297072638767,2.0,1.0,50.0
5572914,1525709666,1525709674,8,220,12.003176657547277,6.46875,1.0,50.0
5572915,1525709671,1525709690,19,64,28.863576903534092,20.0,0.0,51.9
5572916,1525709676,1525709728,52,142,8.743174188732379,5.0,2.8369511932773106,29.454049411764696
5572917,1525709684,1525709728,44,100,4.200372172293411,2.0,1.0,15.732004285714284
5572918,1525709688,1525709728,40,58,5.731330338089051,5.0,1.0269093434746541,20.0
5572919,1525709709,1525709728,19,209,17.905557452240092,20.0,2.0,23.14267843137244
5572920,1525709718,1525709738,20,169,19.153690743638165,20.0,3.0,50.0
5572921,1525709731,1525709754,23,105,4.971703740828323,2.2,2.0,20.0
5572922,1525709743,1525709755,12,54,8.547575551825469,2.0,1.1998700931664952,50.0
5572923,1525709748,1525709770,22,113,6.245725766848975,2.0,2.0,25.0
5572924,1525709770,1525709797,27,159,11.255265532292434,6.0,2.0,50.0
5572925,1525709793,1525709805,12,167,12.375170045010453,5.0,2.0,41.0
5572926,1525709800,1525709846,46,56,23.261302669439868,12.0,0.0,56.0
5572927,1525709845,1525709857,12,142,14.580614693517957,6.0,5.0,41.0
5572928,1525709851,1525709875,24,120,7.030795033441736,5.987047442620932,5.0,20.0
5572929,1525709858,1525709875,17,117,7.028383170228349,5.0,2.0,18.162760784313683
5572930,1525709871,1525709882,11,20,31.462539604591086,20.0,20.0,81.52210606448995
5572931,1525709873,1525709891,18,79,4.5113189901857265,3.034576315789473,1.188534374795453,10.0
5572932,1525709884,1525709900,16,128,8.574467671790867,4.0,2.0,50.0
5572933,1525709895,1525709909,14,118,8.933929350015465,3.0,2.0,50.0
5572934,1525709907,1525709916,9,184,9.062221581083621,5.730369434773317,3.0,32.5886091621955
5572935,1525709910,1525709922,12,9,50.0,50.0,50.0,50.0
5572936,1525709919,1525709938,19,81,48.04913539813874,50.0,20.0,90.0
5572937,1525709930,1525709957,27,134,7.2004986352654035,5.0,1.1,41.0
5572938,1525709955,1525709972,17,260,36.944417530829995,50.0,5.0,50.0
5572939,1525709970,1525709991,21,95,5.594873260175573,4.145306681270537,1.000100000616714,20.846023029015036
5572940,1525709988,1525710007,19,99,5.457083332856204,2.0,1.0001,20.0
5572941,1525710002,1525710018,16,123,11.650795759787954,6.0,2.064586201411384,41.0
5572942,1525710010,1525710035,25,103,11.329033822548778,5.747026078580616,2.0,50.0
5572943,1525710035,1525710042,7,250,7.63922371919155,4.0,1.0,41.0
5572944,1525710040,1525710067,27,46,7.1583700860456805,4.140286437691317,2.3205758464483,33.7393708487084
5572945,1525710055,1525710074,19,95,8.867731176105115,2.4317863087248326,2.0,50.0
5572946,1525710066,1525710074,8,187,5.7015674209417,1.4767786491253359,1.0,24.61005957446808
5572947,1525710069,1525710075,6,19,37.83494832491136,41.0,20.0,50.0
5572948,1525710072,1525710083,11,116,3.055648585892287,2.0,1.0,7.557059494252872
5572949,1525710075,1525710083,8,70,3.651468508020123,1.2234597420122573,1.0,10.3354790060633
5572950,1525710079,1525710090,11,166,9.414014000465679,4.495980435914281,3.0,50.9549676787463
5572951,1525710083,1525710098,15,239,10.068412933728665,6.0,2.0,50.0
5572952,1525710095,1525710108,13,63,4.028421077366368,2.0346896296296295,1.0,20.0
5572953,1525710105,1525710115,10,108,6.988204097121512,4.1,2.0,34.80752337577189
5572954,1525710109,1525710115,6,6,44.62070412950522,44.37160442835976,40.08152741433022,58.81249401054144
5572955,1525710113,1525710123,10,202,7.786583771130523,5.0,3.0,50.0
5572956,1525710120,1525710140,20,214,8.130872984424839,3.0,3.0,50.0
5572957,1525710137,1525710148,11,142,8.387040249307809,3.0,2.0,50.0
5572958,1525710146,1525710155,9,74,5.891019522369435,2.0,1.1,27.54857622377597
5572959,1525710152,1525710163,11,53,3.7393297924283924,2.0,1.0,10.0
5572960,1525710160,1525710181,21,98,7.849388269224361,2.2,2.0,50.0
5572961,1525710172,1525710181,9,196,6.821113614564887,1.0000933809338,1.0,47.00526548962834
5572962,1525710178,1525710192,14,64,3.8621392440248785,2.0,1.0,6.2
5572963,1525710191,1525710221,30,118,7.473644239651573,2.392793472688955,1.0,44.148495883470545
5572964,1525710219,1525710238,19,146,11.284098468107741,6.037152437357631,3.34375,41.0
5572965,1525710230,1525710260,30,174,4.903615105133475,2.0,1.0,9.866282134570755
5572966,1525710251,1525710260,9,177,10.229414635175793,6.0,1.0,49.99530928552881
5572967,1525710257,1525710277,20,116,10.618774752351232,5.4166384090909085,3.0,50.0
5572968,1525710274,1525710288,14,223,10.632416945297615,3.0,1.0,50.0
5572969,1525710288,1525710297,9,93,6.1353456427991,5.0,2.0,18.933049142857133
5572970,1525710294,1525710305,11,99,12.829593227494277,5.848525773615732,3.0,50.0
5572971,1525710302,1525710320,18,81,4.745158127287697,2.0387645334052067,1.0,20.699992972972968
5572972,1525710307,1525710342,35,100,7.284654330941171,6.0,3.0,20.0
5572973,1525710334,1525710349,15,157,13.142294654613453,6.2,2.0,41.0
5572974,1525710344,1525710357,13,67,4.374060992522305,2.0701293740322937,2.0,7.727504499999999
5572975,1525710355,1525710364,9,85,8.154691266246552,5.0,1.3712995423715224,39.023903199999964
5572976,1525710359,1525710373,14,78,6.109585894058026,2.161723053254438,1.0,27.333137767220876
5572977,1525710364,1525710373,9,78,7.2802654051905105,8.0,1.0,12.211204859005402
5572978,1525710373,1525710380,7,115,9.453673308634748,5.0,1.0,50.0
5572979,1525710377,1525710397,20,60,6.454684828466627,4.199791701582589,2.0,24.017455601659716
5572980,1525710395,1525710405,10,206,12.267674301731601,6.0,3.0,50.0
5572981,1525710400,1525710426,26,84,8.397382352919445,4.950742381810727,2.0,50.0
5572982,1525710423,1525710442,19,131,9.910498674294171,5.0,2.0,41.0
5572983,1525710442,1525710453,11,177,18.022437912466778,7.0,3.0,53.073253006413246
5572984,1525710447,1525710467,20,82,7.638290308092492,5.0,2.0,20.0
5572985,1525710464,1525710496,32,45,6.607242989715117,5.0,4.0,13.968159999999989
5572986,1525710496,1525710512,16,186,9.48818596168336,4.0,1.1,50.0
5572987,1525710514,1525710520,6,14,8.197715687823472,7.887573164861612,5.0,8.0
5572988,1525710515,1525710546,31,90,7.732198145555432,5.0,1.8318555837264152,23.543990714285712
5572989,1525710547,1525710569,22,160,9.046287383506696,5.0,1.7991471057692308,36.514843243243256
5572990,1525710568,1525710586,18,97,45.447470701592565,50.0,20.0,74.80305190839694
5572991,1525710586,1525710633,47,163,10.741337047961723,6.0,2.0,45.77030788741695
5572992,1525710633,1525710659,26,167,19.274469520909204,18.05718845315904,5.769851358695652,50.0
5572993,1525710658,1525710674,16,291,10.214297370941493,1.0,1.0,50.0
5572994,1525710675,1525710686,11,147,11.263242804212913,6.0,4.0,37.413418027651886
5572995,1525710684,1525710702,18,113,5.104716576476316,5.0,1.0,8.362152440476168
5572996,1525710699,1525710723,24,134,10.110537431043197,5.0,2.0,21.014066420664196
5572997,1525710723,1525710758,35,104,10.6596752981094,5.0,3.0,39.81668864864859
5572998,1525710757,1525710773,16,217,11.580403827117095,5.185242230586202,1.0,50.0
5572999,1525710771,1525710781,10,240,6.833881811040651,2.0,1.0,28.238951351351332
5573000,1525710778,1525710788,10,47,7.681642929225413,6.0,2.1311210569105694,12.0
5573001,1525710787,1525710795,8,186,18.26508606918763,10.0,3.0,50.0
5573002,1525710790,1525710817,27,95,7.401799118744924,2.1,1.0,20.77571427368421
5573003,1525710810,1525710851,41,157,18.88946704761328,20.0,5.0,50.0
5573004,1525710851,1525710866,15,167,13.327940195082292,6.066430317056237,2.1,41.0
5573005,1525710864,1525710884,20,80,13.745119125102102,5.867518647870303,2.3892384000000004,50.0
5573006,1525710884,1525710901,17,166,20.718461192501767,12.0,3.0,50.0
5573007,1525710890,1525710901,11,111,8.848610272745997,5.252668409090909,3.0,50.0
5573008,1525710895,1525710917,22,204,3.8008592450107717,2.0,1.0,10.0
5573009,1525710915,1525710919,4,92,11.233591346819882,6.0,5.0,22.978401943994445
5573010,1525710918,1525710938,20,65,12.355947880366436,6.0,2.2,50.0
5573011,1525710938,1525710945,7,86,11.186101754950698,5.0,4.840061032666302,50.0
5573012,1525710941,1525710962,21,72,2.7910271634714108,2.0,1.1,18.782162057205696
5573013,1525710960,1525710969,9,134,9.904949564471853,6.0,2.0,46.37215470201464
5573014,1525710965,1525710970,5,80,3.4803179830964126,2.4019673469387754,1.0,13.86544008714597
5573015,1525710966,1525710984,18,96,5.757970625914711,4.0,1.0,12.211212923394738
5573016,1525710974,1525710991,17,43,3.723772096082069,2.7010227731507106,1.0,5.0
5573017,1525710982,1525710999,17,116,7.670868042187054,2.0288629558541267,1.0,50.0
5573018,1525710991,1525711006,15,130,9.55890114699393,5.557570037451248,3.0,31.471965999999984
5573019,1525711003,1525711031,28,92,8.969551340695864,5.0,2.0,41.0
5573020,1525711030,1525711040,10,112,20.613478007709833,10.0,2.0,60.0
5573021,1525711034,1525711058,24,105,6.287769987907597,5.0,1.5,17.563764210526294
5573022,1525711052,1525711066,14,51,12.962136601462593,5.0,1.0000003143598573,50.0
5573023,1525711059,1525711098,39,105,11.336861687569597,5.390473748558247,2.0,50.0
5573024,1525711093,1525711107,14,154,18.658311388215807,10.0,2.0,50.0
5573025,1525711096,1525711107,11,19,3.2117093193879445,2.0,2.0,4.794968196337225
5573026,1525711102,1525711154,52,73,9.31329447265901,5.0,2.0,50.0
5573027,1525711150,1525711198,48,188,21.13774860292491,10.0,3.0,50.0
5573028,1525711175,1525711199,24,188,19.765791796205434,7.178611927272727,3.0,56.0
5573029,1525711179,1525711199,20,107,6.105970299140203,5.0,3.0,10.0
5573030,1525711184,1525711199,15,14,8.233554679302774,7.8426409544249465,2.0,21.090218673341674
5573031,1525711189,1525711199,10,59,6.116480473609218,5.0,2.0,9.313375499999996
5573032,1525711191,1525711227,36,59,6.067052978303756,4.1322715789473685,2.0,23.8056263123909
5573033,1525711224,1525711310,86,196,16.851785617096578,6.0,4.0,50.0
5573034,1525711309,1525711335,26,154,20.490017204200647,10.0,5.0,50.0
5573035,1525711333,1525711352,19,88,51.43044031161514,50.0,41.0,61.124016896140716
5573036,1525711351,1525711410,59,151,11.301933165525794,6.0,5.0,30.0
5573037,1525711412,1525711441,29,191,27.029129987845398,20.27221768707483,6.0,52.68757659574467
5573038,1525711440,1525711452,12,318,2.6315787113758655,1.0,1.0,29.067049386716025
5573039,1525711442,1525711452,10,265,13.464898456564775,5.286664574136188,1.0,50.0
5573040,1525711444,1525711453,9,70,8.292119638884326,5.46510553284721,5.0,13.004464684879014
5573041,1525711448,1525711491,43,222,4.608833706014957,4.0,1.0,8.644642727272721
5573042,1525711490,1525711513,23,146,12.388616299262578,6.0,3.0,50.0
5573043,1525711505,1525711514,9,199,8.680455914879511,4.0,1.0,50.0
5573044,1525711509,1525711521,12,33,33.815631651286076,30.0,20.0,50.0
5573045,1525711517,1525711529,12,112,8.812388579428271,5.0,3.0,50.0
5573046,1525711527,1525711541,14,225,7.578993906351981,5.0,1.0,41.0
5573047,1525711540,1525711550,10,125,11.230767844664294,5.0,2.0,24.322265576323986
5573048,1525711541,1525711558,17,80,5.302080921900243,2.6154378914728684,2.0,10.696737777777772
5573049,1525711559,1525711566,7,228,16.233338471402977,5.0,1.0,56.0
5573050,1525711565,1525711594,29,73,8.17175506626183,5.056444363605404,2.2,20.637073888949374
5573051,1525711583,1525711594,11,138,12.5450972175959,5.0,3.0,50.0
5573052,1525711588,1525711623,35,120,7.791152819506925,5.615101818181818,3.0,30.0
5573053,1525711622,1525711639,17,120,23.90500370011839,5.0,4.0,78.90678878504667
5573054,1525711630,1525711648,18,201,11.541767855592315,5.0,3.0,50.0
5573055,1525711639,1525711656,17,95,11.37632713332872,5.0,1.0,50.0
5573056,1525711648,1525711673,25,144,7.430588861319278,5.0,1.4702870833333335,42.344592675832345
5573057,1525711673,1525711703,30,133,10.89594081836108,5.94984690753215,2.0,50.0
5573058,1525711693,1525711712,19,107,13.787831101484276,6.0,3.0,50.0
5573059,1525711708,1525711721,13,91,8.680663477197585,4.0,1.6975451600985223,50.0
5573060,1525711719,1525711731,12,112,11.765517860538907,5.310928881199539,1.0,50.0
5573061,1525711721,1525711738,17,95,5.373401696677973,2.0,1.5,14.79342952235831
5573062,1525711733,1525711747,14,73,7.868888004096192,5.0,1.7648091672817212,24.38263157894733
5573063,1525711745,1525711757,12,103,14.972739056501576,6.0,5.0,50.0
5573064,1525711756,1525711776,20,127,4.355695828271842,2.5,2.0,10.0
5573065,1525711773,1525711785,12,138,12.601607077173135,5.989696634241246,3.0,51.9
5573066,1525711779,1525711794,15,83,6.3149546844023945,4.0,2.0,33.56346715444224
5573067,1525711787,1525711802,15,82,7.834366568841497,4.283178620334636,1.1,50.0
5573068,1525711793,1525711811,18,102,9.212691234470148,5.0,3.0,50.0
5573069,1525711808,1525711839,31,92,6.35993548410523,2.0,1.0125436691467258,30.511944712311845
5573070,1525711826,1525711853,27,99,17.04442441746554,5.0,4.0,60.64370619607842
5573071,1525711855,1525711881,26,220,32.23289136482741,28.0,6.0,51.98026974619288
5573072,1525711879,1525711895,16,172,9.967298932928523,6.0,4.0,50.0
5573073,1525711894,1525711907,13,114,10.116357382026871,5.0,1.0,50.0
5573074,1525711907,1525711921,14,193,8.05985930587882,5.0,2.0,41.375269803582846
5573075,1525711913,1525711939,26,135,7.742709768028867,5.0,1.0,50.0
5573076,1525711938,1525711949,11,228,21.532746698213625,12.0,3.0,50.0
5573077,1525711942,1525711957,15,188,12.193802189851175,6.0,3.0,50.0
5573078,1525711950,1525711986,36,133,9.654633789119503,4.0,1.0,50.0
5573079,1525711978,1525712011,33,151,16.37730168727627,6.0,5.0,50.0
5573080,1525711989,1525712037,48,166,4.192071226306228,2.174643495934959,1.0,20.0
5573081,1525712039,1525712079,40,178,24.49027640617304,15.358669438243957,5.749891331521739,50.0
5573082,1525712079,1525712086,7,316,14.42829725878936,1.0,1.0,50.0
5573083,1525712084,1525712094,10,111,34.25165186226552,34.08023586206897,15.000000000527999,50.84948077142857
5573084,1525712093,1525712104,11,153,6.587630275901358,5.0,1.0,23.128659991766128
5573085,1525712102,1525712112,10,176,8.361791882790524,5.0,4.0,49.82418919591113
5573086,1525712107,1525712121,14,78,5.2224413856414635,4.0,1.0,7.787833482944339
5573087,1525712118,1525712131,13,161,10.547381289092595,6.0,2.0,20.193598842176844
5573088,1525712121,1525712138,17,81,7.4321474387947735,5.0,2.0,50.0
5573089,1525712138,1525712161,23,115,16.67156656339287,6.0,3.0,50.0
5573090,1525712159,1525712170,11,169,11.043113725729336,5.891272436904189,3.0,50.0
5573091,1525712161,1525712194,33,25,5.143522615824844,3.0,2.0,45.16896934556704
5573092,1525712194,1525712203,9,223,17.356540083645655,6.0,3.0,50.0
5573093,1525712200,1525712210,10,97,4.1920651215251885,2.5398955538107684,2.0,5.0
5573094,1525712202,1525712230,28,46,5.791338520082513,5.0,2.0,20.0
5573095,1525712224,1525712238,14,203,10.028556433309053,2.1079946031746033,2.0,50.0
5573096,1525712234,1525712244,10,13,50.657046634598174,50.0,50.0,50.08585356707603
5573097,1525712240,1525712264,24,152,11.204560963287129,5.7083855728155335,2.2,50.0
5573098,1525712257,1525712266,9,114,9.158718926907591,5.0,4.0,40.74952605627213
5573099,1525712260,1525712282,22,58,6.518935992569163,5.0,2.0,22.312653061224427
5573100,1525712270,1525712291,21,120,6.813401832312402,2.167697396449704,1.5,50.0
5573101,1525712282,1525712301,19,120,7.831311159555247,4.311451003045902,2.0,41.0
5573102,1525712288,1525712333,45,99,7.979816268915872,6.0,2.5,20.109404059040592
5573103,1525712333,1525712358,25,173,14.704734433669675,5.170962666666666,3.0,50.0
5573104,1525712357,1525712367,10,147,19.08838859754833,6.0,4.0,50.0
5573105,1525712366,1525712383,17,49,9.631074156242416,4.528479704797049,2.0,50.0
5573106,1525712379,1525712393,14,53,45.77680700500833,50.0,21.800199204584512,55.55584999999999
5573107,1525712389,1525712408,19,99,6.229428929711642,5.0,2.0,10.0
5573108,1525712391,1525712408,17,76,3.214981011894995,2.1,2.0,4.344368582785344
5573109,1525712394,1525712435,41,160,5.02251168073812,5.0,1.5,16.92309999999997
5573110,1525712434,1525712459,25,173,19.81035796445101,15.0,5.0,50.0
5573111,1525712449,1525712460,11,160,7.948055590130838,5.051031747572815,2.0,48.2656421514818
5573112,1525712453,1525712480,27,115,7.087793501903917,5.0,3.0,25.0
5573113,1525712473,1525712498,25,218,9.098111428685874,5.0,1.0,50.0
5573114,1525712497,1525712515,18,244,12.770908262384856,5.0,1.0,50.0
5573115,1525712512,1525712516,4,98,35.38350511500267,6.076663226105069,2.9430572916666673,100.0
5573116,1525712516,1525712565,49,211,20.376242221273746,3.0,1.0,56.0
5573117,1525712564,1525712590,26,240,21.544559713324624,10.0,1.0,50.0
5573118,1525712587,1525712599,12,196,12.083555101308347,5.029807677685951,1.0,50.0
5573119,1525712592,1525712611,19,120,34.22304406568174,5.0,1.5,100.0
5573120,1525712610,1525712620,10,182,14.011195785472944,6.0,2.0,51.21261968658124
5573121,1525712618,1525712628,10,65,56.405055063059436,56.0,56.0,56.0
5573122,1525712625,1525712652,27,107,34.79536652404838,5.91450171368265,2.0,100.0
5573123,1525712641,1525712660,19,87,14.935732310189325,5.0,2.0,50.0
5573124,1525712645,1525712661,16,243,9.229027741620117,1.0,1.0,52.692568002617705
5573125,1525712651,1525712670,19,69,9.807394679669638,5.0,2.0,50.0
5573126,1525712667,1525712682,15,84,9.952639005150727,3.0,2.0,50.0
5573127,1525712684,1525712695,11,105,52.606035679024004,56.0,41.213605591508134,56.0
5573128,1525712692,1525712727,35,127,6.074149264923183,5.0,1.0,22.334840399181736
5573129,1525712726,1525712734,8,102,15.1628195066686,2.0,2.0,51.9
5573130,1525712732,1525712753,21,79,6.838240705513639,5.0,2.0,40.1200653622667
5573131,1525712750,1525712761,11,96,14.044639404999721,6.0,4.0,50.0
5573132,1525712759,1525712768,9,119,7.204672658559036,5.0,1.0,46.34837370647847
5573133,1525712764,1525712780,16,90,12.077088537535131,6.0,4.0,50.0
5573134,1525712771,1525712781,10,12,8.334048448715604,7.787422487475208,3.0,46.20898139130434
5573135,1525712773,1525712789,16,101,7.139848173350681,5.0,2.0,37.004809075698134
5573136,1525712784,1525712821,37,83,6.420725390531415,2.8807709075981527,1.5,41.753388888888665
5573137,1525712820,1525712828,8,21,51.65623131818122,50.0,48.73026014302005,80.0
5573138,1525712823,1525712846,23,205,15.2520421593483,5.511514325119458,1.0,50.0
5573139,1525712840,1525712855,15,94,8.501636238189747,5.0,2.0,46.809452544205996
5573140,1525712853,1525712862,9,87,10.75385875884508,2.577983710519771,2.0,50.0
5573141,1525712859,1525712876,17,96,4.547003484985603,4.340970212765957,1.2259369391562667,7.54464835164835
5573142,1525712865,1525712883,18,125,15.872008233288819,3.0,2.024860170195092,50.0
5573143,1525712883,1525712920,37,116,7.823491111367057,5.557755383765875,2.0,41.0
5573144,1525712919,1525712927,8,138,21.01616148428459,5.0,4.0,50.0
5573145,1525712920,1525712928,8,12,7.386543451917143,7.637237470016412,2.0,8.0
5573146,1525712923,1525712940,17,85,4.934658603917504,4.661262807017544,1.0,8.113770666666664
5573147,1525712940,1525712948,8,191,14.636211310651474,5.784297553275454,3.0,50.0
5573148,1525712945,1525712958,13,124,8.339776155968744,5.0,3.0,30.0
5573149,1525712957,1525712964,7,35,42.198697447283855,50.0,23.00039659180883,50.09005152676205
5573150,1525712959,1525712981,22,135,5.670102782977712,4.0,2.0,12.0
5573151,1525712977,1525712982,5,96,9.677719310878487,5.0,3.0,50.0
5573152,1525712982,1525712997,15,39,4.5510521265545965,2.0,2.0,21.11799216454457
5573153,1525712992,1525713021,29,92,20.433887513200478,5.0,2.0,53.56539438673584
5573154,1525713020,1525713029,9,170,28.395784616526342,7.251314814814821,1.3235300663504477,53.49374164819276
5573155,1525713026,1525713036,10,120,5.976910111413438,5.0,1.5,24.680947747747744
5573156,1525713031,1525713044,13,74,17.30667111237515,5.92266285992218,4.0,56.0
5573157,1525713044,1525713089,45,102,12.311456499011458,5.0,2.0,53.26204537499997
5573158,1525713088,1525713130,42,188,22.98457367902092,15.000000000384311,5.0,50.0
5573159,1525713130,1525713143,13,195,16.1938816772186,6.0,4.0,50.0
5573160,1525713143,1525713153,10,112,14.16744145616762,5.9330660271844655,3.3,50.0
5573161,1525713153,1525713164,11,341,6.910535098072756,1.0,1.0,50.0
5573162,1525713160,1525713172,12,133,7.491658548384005,3.0,2.0,50.0
5573163,1525713167,1525713206,39,75,17.582311023924987,5.9265858909943,4.0,56.0
5573164,1525713208,1525713220,12,163,33.870356557440275,50.0,6.0,56.0
5573165,1525713215,1525713245,30,137,6.773949968041624,5.368726117647058,1.0,10.0
5573166,1525713242,1525713280,38,140,17.01404146287772,5.9508911881126565,2.0,50.0
5573167,1525713289,1525713318,29,218,16.706732493335018,6.0,2.0,50.0
5573168,1525713318,1525713342,24,201,21.611746816543288,8.998832000000002,1.0,50.0
5573169,1525713341,1525713365,24,45,42.452585814922976,50.0,20.0,54.93872916445722
5573170,1525713358,1525713374,16,287,8.831011810945931,1.0,1.0,50.0
5573171,1525713363,1525713375,12,79,11.372881690412656,6.0,3.665971749717717,35.29253603603592
5573172,1525713373,1525713391,18,155,7.929939697463318,2.8,1.0,50.0
5573173,1525713382,1525713398,16,98,8.143633826166637,5.0,1.5,50.0
5573174,1525713390,1525713400,10,79,6.301311933412212,2.058171769037426,2.0,32.23907808049525
5573175,1525713395,1525713407,12,77,26.888233409219545,8.0,1.0,56.0
5573176,1525713400,1525713407,7,144,5.126743787046165,2.0,1.1,21.044709445947458
5573177,1525713403,1525713415,12,73,19.06963303991388,5.700714797611148,3.0,56.0
5573178,1525713408,1525713427,19,75,7.492215836492986,2.1,1.0,50.0
5573179,1525713427,1525713435,8,84,52.88796612394543,56.0,30.619028,56.0
5573180,1525713433,1525713451,18,108,8.753262184095009,5.197644532991641,3.0,27.56124307539523
5573181,1525713451,1525713493,42,61,55.95433563891325,56.0,56.0,56.0
5573182,1525713493,1525713501,8,48,24.5453851702675,9.667004444444446,4.0,53.51980070175438
5573183,1525713500,1525713510,10,148,50.81077055766407,50.0,50.0,56.0
5573184,1525713508,1525713520,12,172,12.218531928111753,6.0,4.0,50.0
5573185,1525713518,1525713536,18,45,11.181211365786098,4.500666769230769,1.092519144896639,50.0
5573186,1525713531,1525713543,12,50,38.54983149606996,50.0,20.0,50.0
5573187,1525713533,1525713551,18,104,8.11524849712064,5.7468859345561905,4.0,28.303452791317508
5573188,1525713543,1525713576,33,131,9.309980000371155,3.0,2.0,50.0
5573189,1525713570,1525713585,15,114,35.60635369400412,50.0,0.0,50.0
5573190,1525713578,1525713606,28,38,23.391720804086283,17.228709199367316,0.0,50.0
5573191,1525713606,1525713652,46,168,16.97009975316493,6.0,5.0,50.0
5573192,1525713643,1525713659,16,117,18.35512164448168,15.000000000715636,5.0,50.0
5573193,1525713649,1525713660,11,80,12.573458631661728,6.0,5.0,50.0
5573194,1525713653,1525713685,32,89,7.291125269157544,4.346370048429932,3.34375,20.0
5573195,1525713684,1525713703,19,96,14.054746631028113,6.0028511455681555,5.0,50.0
5573196,1525713701,1525713720,19,67,24.87941970104428,17.472524793893925,0.0,60.55070952380951
5573197,1525713719,1525713778,59,157,8.453056769895742,4.0,2.169883479918665,50.0
5573198,1525713778,1525713787,9,162,19.098156475581614,13.779459523862613,5.0,50.0
5573199,1525713782,1525713796,14,147,20.23736854055599,15.414813681744606,5.21,50.0
5573200,1525713792,1525713815,23,179,13.993572399634754,6.0,5.0,50.0
5573201,1525713813,1525713826,13,111,11.05140086522004,5.354904607250756,4.0,50.0
5573202,1525713823,1525713849,26,85,31.977215777483842,20.0,14.4,50.0
5573203,1525713848,1525713857,9,128,8.24267944053135,6.0,5.0,20.0
5573204,1525713855,1525713875,20,239,8.063162411985854,4.0,1.0,41.0
5573205,1525713870,1525713884,14,116,12.419647064033684,6.0,3.907565953200332,50.0
5573206,1525713882,1525713893,11,122,5.210754934663803,3.0,2.0,20.0
5573207,1525713889,1525713903,14,79,8.301466803471996,4.174219709677419,3.0,40.14985117294565
5573208,1525713891,1525713903,12,69,9.934508609708509,5.0,3.0,50.0
5573209,1525713900,1525713978,78,110,10.829704938122926,5.0,3.0,50.0
5573210,1525713978,1525713994,16,169,31.60147943146113,21.0,10.0,51.9
5573211,1525713993,1525714004,11,138,12.03309735134665,5.4217036511911365,5.0,20.828984456566886
5573212,1525714002,1525714049,47,65,57.56020357562387,56.0,56.0,72.03513699999999
5573213,1525714049,1525714070,21,305,14.18393486013705,1.0,1.0,50.0
5573214,1525714068,1525714082,14,63,56.57103469923316,56.0,56.0,57.301847019200146
5573215,1525714071,1525714082,11,77,55.34505802806225,56.0,50.0,56.0
5573216,1525714075,1525714104,29,145,20.087742696241524,10.042265671641795,6.0,50.0
5573217,1525714103,1525714121,18,107,10.607779120088631,5.329880230680507,5.0,30.0
5573218,1525714121,1525714133,12,120,8.885580409679806,6.0,4.0,25.0
5573219,1525714131,1525714140,9,77,13.450117905338546,5.0,4.0,56.0
5573220,1525714135,1525714158,23,66,5.056828648612376,4.200859778597785,3.6886524144465005,9.173669770034076
5573221,1525714151,1525714187,36,176,7.147958185428867,3.0,3.0,20.758421010101006
5573222,1525714189,1525714197,8,154,19.048497275656096,10.0,4.0,56.0
5573223,1525714196,1525714218,22,13,40.17485948089016,50.0,1.1246630327125817,50.72872897356677
5573224,1525714217,1525714230,13,195,21.626470176046425,15.0,15.0,50.0
5573225,1525714229,1525714282,53,15,47.18493122385078,50.0,23.058984132841328,74.38885123966938
5573226,1525714281,1525714299,18,124,18.813565840134764,10.0,5.374239616352831,62.00902339181271
5573227,1525714299,1525714309,10,184,10.680115588528219,6.0,5.0,50.0
5573228,1525714306,1525714318,12,70,53.72881408287689,56.0,50.0,56.0
5573229,1525714313,1525714338,25,207,8.050070569026017,5.0,1.0,22.519192733163617
5573230,1525714335,1525714347,12,133,7.558317759620753,5.0,2.5,28.675323333333317
5573231,1525714339,1525714364,25,119,5.914206144851586,3.1626207546352463,2.48489422232128,13.4163154929575
5573232,1525714356,1525714373,17,87,11.815532365677553,6.0,5.0,50.0
5573233,1525714364,1525714374,10,42,8.896374884951816,5.400406909363323,4.0,50.0
5573234,1525714372,1525714382,10,30,50.88728101524267,50.0,21.29375680976248,91.0
5573235,1525714373,1525714391,18,132,7.352349006417666,5.0,3.0,16.070838604681047
5573236,1525714389,1525714408,19,259,3.749094250028968,1.2764857142857169,1.0,9.830800744047616
5573237,1525714393,1525714409,16,46,5.1314031301130525,5.725052956056312,1.0,8.656245999999996
5573238,1525714395,1525714418,23,79,7.058432696829219,5.0,3.0,20.0
5573239,1525714411,1525714448,37,70,10.332941843695668,5.675433742189308,5.0,40.07349640551544
5573240,1525714448,1525714498,50,187,13.790197032931376,5.0,3.0,50.0
5573241,1525714497,1525714509,12,125,28.17343288602659,20.0,6.0,50.0
5573242,1525714509,1525714519,10,83,5.938166758356377,5.319187278688524,1.0,6.441706413142745
5573243,1525714511,1525714527,16,108,8.76079525072174,4.0,3.0,27.583760911161725
5573244,1525714520,1525714544,24,75,10.373626872648545,5.908205023657331,2.0,20.0
5573245,1525714537,1525714561,24,46,51.39261545850419,50.0,20.456390207700387,87.6098104513064
5573246,1525714560,1525714585,25,140,10.572604885951499,5.980402337525036,4.0,41.0
5573247,1525714584,1525714600,16,65,16.781891058539664,5.0,4.0,60.0
5573248,1525714599,1525714608,9,146,8.495314782181746,5.0,2.5,40.48374902557631
5573249,1525714603,1525714637,34,149,12.648691873871478,6.0,1.0,50.0
5573250,1525714637,1525714700,63,104,23.57485978486649,15.000000000454147,5.5,52.83423362720639
5573251,1525714699,1525714724,25,141,17.13723830936367,10.0,5.0,50.0
5573252,1525714725,1525714759,34,113,40.404373281846766,41.0,12.0,87.22396847635723
5573253,1525714758,1525714769,11,124,6.812230943239762,5.0,5.0,10.0
5573254,1525714763,1525714779,16,74,6.251423827353891,5.0,4.0,20.0
5573255,1525714770,1525714779,9,147,4.902020421867475,3.0,2.0,10.0
5573256,1525714778,1525714792,14,100,10.584354376886639,6.0,4.0,50.0
5573257,1525714790,1525714805,15,116,17.155452586327062,5.0,3.0,50.0
5573258,1525714802,1525714822,20,167,7.081068081199649,3.0,1.0,41.0
5573259,1525714808,1525714830,22,99,17.384587504201757,6.0,3.0,50.0
5573260,1525714823,1525714848,25,91,8.205524345767163,5.0,2.0,47.13191634034024
5573261,1525714841,1525714859,18,85,9.440830847335107,4.183214376879574,2.0,46.36804370400468
5573262,1525714858,1525714887,29,198,11.54898299345892,6.0,1.0,41.900144658102384
5573263,1525714887,1525714897,10,275,11.216969061233671,1.0,1.0,41.0
5573264,1525714894,1525714915,21,72,7.388925114333429,5.0,4.0,25.513235999999985
5573265,1525714914,1525714926,12,138,16.125161443211216,10.0,5.0,50.0
5573266,1525714925,1525714948,23,97,12.980509590658022,6.0,1.0,50.0
5573267,1525714947,1525714990,43,102,12.678880667477877,5.8075008780487805,5.0,50.0
5573268,1525714989,1525715006,17,210,21.644699962434217,12.0,6.2,51.9
5573269,1525715005,1525715029,24,139,9.002571402891435,5.0,4.0,50.0
5573270,1525715028,1525715051,23,86,7.561199314194562,2.13868275862069,2.0,50.0
5573271,1525715050,1525715060,10,165,19.533198683980377,8.0,4.0,50.71129528378181
5573272,1525715054,1525715087,33,132,4.57228677108786,4.253387342473342,2.0,6.0
5573273,1525715084,1525715096,12,173,15.330949081166635,6.01055052631579,4.0,50.0
5573274,1525715089,1525715105,16,68,5.329788564237427,5.0,1.0,6.458039707568807
5573275,1525715098,1525715113,15,59,5.911113330320567,5.0,3.0,14.301146047604881
5573276,1525715108,1525715122,14,104,8.332040182102027,5.0,3.0,30.79543542435419
5573277,1525715117,1525715131,14,117,10.426913731207712,5.552543577235771,3.0,50.0
5573278,1525715126,1525715141,15,63,5.124031751851985,5.0,2.0,9.573648637110352
5573279,1525715129,1525715141,12,10,7.699448270105253,5.989952788706318,4.2337557195571955,20.0
5573280,1525715136,1525715150,14,114,3.9812632492751288,2.0,2.0,10.0
5573281,1525715144,1525715160,16,86,6.2316428632304435,5.0,2.0,23.35817663317219
5573282,1525715150,1525715160,10,171,3.4685341185424265,2.0,1.5,8.643084959538966
5573283,1525715154,1525715160,6,159,4.674618096299388,5.0,1.5,7.517199638009049
5573284,1525715157,1525715217,60,16,8.460047953524517,7.987996259351621,6.032517712177122,8.0
5573285,1525715205,1525715218,13,226,15.909613817649232,3.0,3.0,81.61102046783625
5573286,1525715209,1525715227,18,166,14.367305915877802,10.0,4.989051428571429,41.0
5573287,1525715222,1525715240,18,124,10.67377656644488,5.869003745491538,5.0,50.0
5573288,1525715239,1525715267,28,242,11.963009014498246,5.0,4.0,50.0
5573289,1525715266,1525715280,14,138,7.56379191344166,5.187255866648849,3.0,23.50129082435442
5573290,1525715274,1525715300,26,41,8.019882962814094,5.0,5.0,23.10652853671472
5573291,1525715299,1525715323,24,256,95.39348532670131,4.0,1.0,50.0
5573292,1525715318,1525715339,21,130,10.624034493099982,5.041665086206897,1.0,50.0
5573293,1525715322,1525715340,18,47,19.43555844379335,7.0,5.0,72.82693440445676
5573294,1525715331,1525715356,25,38,3.755437115571504,3.0,1.0,31.66725765217391
5573295,1525715352,1525715373,21,183,19.016537312369902,6.0,3.0,50.0
5573296,1525715372,1525715390,18,223,6.0847772156197655,3.0,1.0,25.0
5573297,1525715389,1525715407,18,121,6.825197490627701,3.0,2.0,21.343920048811334
5573298,1525715399,1525715444,45,154,12.687700639441138,6.0,3.0,50.0
5573299,1525715437,1525715444,7,166,19.008950558013694,17.377723097976265,5.0,50.0
5573300,1525715443,1525715454,11,61,5.499521291241376,5.0,2.0,14.039544399999995
5573301,1525715453,1525715463,10,114,4.5884230342562855,2.0,2.0,15.0
5573302,1525715461,1525715472,11,131,6.2533943915067605,3.0,1.5,20.0
5573303,1525715467,1525715484,17,67,9.753648430140597,6.0,5.0,50.0
5573304,1525715484,1525715500,16,97,11.38380335979291,5.0,4.0,50.0
5573305,1525715499,1525715508,9,92,10.619783807148089,5.944647446808511,3.0,29.963280182648397
5573306,1525715504,1525715518,14,10,44.256391815235006,41.0,28.166800000000002,81.83298205743817
5573307,1525715517,1525715527,10,62,5.900410239803704,5.4490889409178,2.7538248502574882,10.146593332632241
5573308,1525715526,1525715535,9,200,13.487251173588792,3.0,3.0,56.0
5573309,1525715531,1525715558,27,27,9.47380095547126,6.5706176311962805,2.6329420086660282,39.030785123966936
5573310,1525715550,1525715566,16,149,6.742488891594255,4.124703069329197,2.0,20.0
5573311,1525715557,1525715575,18,12,7.567582761735541,7.678344720708217,1.6635551889944162,9.844735926380368
5573312,1525715561,1525715575,14,117,4.330633051781894,2.0,2.0,6.0
5573313,1525715571,1525715590,19,149,7.802215820584581,4.0,1.5,38.920909001325775
5573314,1525715580,1525715602,22,89,11.900738391046175,5.0,1.5833405895757648,46.24748390947525
5573315,1525715598,1525715627,29,90,4.8417699327013475,2.0,1.0291987325,25.0
5573316,1525715611,1525715627,16,141,8.867005780183717,5.579316264537968,2.1,50.0
5573317,1525715620,1525715638,18,125,9.813610191268932,2.0450829333333336,2.0,50.0
5573318,1525715634,1525715647,13,111,24.19245179209147,15.0,15.0,50.0
5573319,1525715640,1525715655,15,100,6.759997915952929,5.0,2.0,24.52017730496449
5573320,1525715654,1525715686,32,94,12.109750045160876,5.0649880861850445,2.025324493678924,50.0
5573321,1525715682,1525715710,28,136,8.245790645772516,5.788859639994648,3.0,21.13581261261258
5573322,1525715711,1525715721,10,121,15.464937815312798,10.0,2.0,52.991923981900435
5573323,1525715715,1525715755,40,95,15.994707150918973,6.0,2.0,50.0
5573324,1525715752,1525715765,13,163,19.083327167693106,8.0,5.0,56.0
5573325,1525715762,1525715791,29,172,9.886700686865227,4.0,2.0,50.0
5573326,1525715789,1525715802,13,199,17.802881406980145,7.155607468559345,1.0,56.0
5573327,1525715795,1525715813,18,300,4.4640088641936,1.0,1.0,25.0
5573328,1525715805,1525715825,20,69,7.119076444337282,5.0,1.2950481840695183,31.586705405405286
5573329,1525715807,1525715825,18,15,3.7435122995993266,3.046766373782762,2.159194903687155,4.932069560359503
5573330,1525715811,1525715833,22,101,3.763109600700528,2.0,2.0,6.124698842105263
5573331,1525715828,1525715939,111,205,7.609034150622167,2.2,2.0,30.0
5573332,1525715939,1525715948,9,265,19.514240188226132,12.0,1.0,50.0
5573333,1525715946,1525715955,9,161,11.194508651977264,6.0,1.0,50.0
5573334,1525715952,1525715963,11,120,4.173139315782371,3.0,2.0,5.0
5573335,1525715957,1525715971,14,128,5.270268517151979,2.0,1.0,28.082481249999972
5573336,1525715962,1525715971,9,175,25.286193041427207,8.0,1.0,56.0
5573337,1525715969,1525715994,25,69,6.7829612692717625,4.000000000160089,2.0,28.0
5573338,1525715987,1525716005,18,58,51.233809122777195,56.0,25.68676666666667,56.0
5573339,1525716003,1525716013,10,143,8.61950744148747,5.0,2.0,50.0
5573340,1525716005,1525716021,16,21,5.755274657486287,2.0,2.0,31.414976247389355
5573341,1525716021,1525716064,43,142,6.723038955451375,2.2157405778231345,2.0,30.0
5573342,1525716064,1525716082,18,131,21.6295578284175,15.208374018092622,5.0,50.0
5573343,1525716073,1525716083,10,122,9.368588696316456,5.0,2.0,35.53557312252961
5573344,1525716076,1525716083,7,83,50.51108768862654,56.0,20.853171257085293,56.0
5573345,1525716080,1525716090,10,75,4.638412606099336,4.0,1.1011794812576905,13.66557056603773
5573346,1525716084,1525716099,15,95,5.241094003674896,1.7160409902912621,1.0,25.18448648648638
5573347,1525716095,1525716120,25,82,15.570656386809553,5.858587897669472,4.0,56.0
5573348,1525716119,1525716133,14,151,7.058824446895813,2.0,2.0,40.41166444205577
5573349,1525716134,1525716140,6,64,57.96577517513577,56.0,56.0,64.15586328475733
5573350,1525716136,1525716152,16,137,24.790404588465133,11.292461254612544,3.0,56.0
5573351,1525716151,1525716160,9,104,8.012484023105397,5.0,2.0,50.0
5573352,1525716157,1525716170,13,113,5.730207165306153,2.0,1.0,42.27602097457748
5573353,1525716168,1525716208,40,80,8.254664426050132,5.0,1.0495410112022212,41.0
5573354,1525716208,1525716216,8,200,18.218688197811463,6.0,1.0,52.1606332984465
5573355,1525716213,1525716236,23,73,51.239659004408345,51.9,40.48659723519616,56.0
5573356,1525716235,1525716247,12,211,6.173923671957958,5.0,1.0,15.511515735402632
5573357,1525716248,1525716254,6,10,21.283416999866173,16.259898925440975,15.000000000081712,50.0
5573358,1525716251,1525716269,18,93,3.666583171969707,2.0,1.0,7.942303066666666
5573359,1525716268,1525716282,14,28,35.43864108831175,30.0,20.0,51.82929707144922
5573360,1525716274,1525716289,15,209,5.214680051438861,5.0,1.0,10.0
5573361,1525716283,1525716297,14,48,7.583498863970659,6.0,5.0,9.657804970067115
5573362,1525716292,1525716343,51,76,9.818996190946011,6.0,5.0,28.0
5573363,1525716344,1525716353,9,154,17.50174704192201,6.0,4.0,52.45612976056087
5573364,1525716351,1525716381,30,97,15.270204039127801,6.850610666666667,5.0,50.0
5573365,1525716379,1525716390,11,112,23.503953764322564,11.453234472582835,5.0,51.86467908277367
5573366,1525716386,1525716409,23,290,2.550824553357209,1.0,1.0,4.0117594230769225
5573367,1525716399,1525716423,24,218,7.042856938602737,4.0,2.0,40.62940541394563
5573368,1525716421,1525716431,10,165,7.701581110889049,4.0,2.0,27.93050823529411
5573369,1525716429,1525716457,28,174,17.86138699396495,10.0,5.0,50.0
5573370,1525716454,1525716466,12,202,5.604817455961346,2.0,2.0,10.726463348416278
5573371,1525716461,1525716483,22,212,9.417727608249656,4.321584623895814,3.0,50.0
5573372,1525716477,1525716509,32,189,5.0288952570843435,2.0,1.5,24.145074600489757
5573373,1525716508,1525716531,23,109,16.52191434286137,6.0,5.0,50.0
5573374,1525716532,1525716552,20,83,42.404199889439006,50.0,15.0,56.0
5573375,1525716551,1525716560,9,132,17.89973511975803,6.0,5.0,56.0
5573376,1525716558,1525716583,25,100,5.9648167638943175,2.207896287248666,2.0,50.0
5573377,1525716579,1525716592,13,142,8.608098365816799,5.0,2.0,41.966937972992945
5573378,1525716586,1525716602,16,279,3.0977495421104333,1.5,1.0,5.0
5573379,1525716593,1525716602,9,5,49.67067398920438,50.0,42.50097076023392,50.0
5573380,1525716596,1525716610,14,180,6.198317849013471,5.0,3.0,15.511514284467154
5573381,1525716599,1525716625,26,3,27.15064374294217,25.526488322717622,20.0,50.0
5573382,1525716623,1525716633,10,217,8.795072088888466,5.0,1.5,43.27175354086504
5573383,1525716632,1525716674,42,186,14.990245104829429,7.842667424667631,4.0,50.0
5573384,1525716671,1525716683,12,203,11.90580541651223,6.0,4.0,50.0
5573385,1525716685,1525716692,7,96,10.34265231137705,5.0,2.0,50.0
5573386,1525716692,1525716707,15,216,6.786190898106971,5.0,1.5,20.0
5573387,1525716706,1525716724,18,125,13.292102295651317,6.0,3.0,50.0
5573388,1525716723,1525716748,25,182,4.8362165603530745,2.0,1.0,14.655723072339148
5573389,1525716746,1525716757,11,182,12.354127982124483,6.0,3.0,50.1503745811568
5573390,1525716756,1525716805,49,95,4.048824198472527,2.0,1.0,20.0
5573391,1525716804,1525716815,11,228,15.117907271792998,8.344584422528524,1.0,50.0
5573392,1525716815,1525716845,30,29,39.37886704573811,50.0,20.0,50.0
5573393,1525716844,1525716876,32,313,3.669209343083544,1.0,1.0,15.525316627831293
5573394,1525716875,1525716884,9,186,22.91282164660515,16.60663830234375,1.0,50.0
5573395,1525716879,1525716903,24,167,4.482915103465987,4.000000001,2.2,9.2034517935663
5573396,1525716902,1525716947,45,227,6.736206089004733,2.0,1.0,50.0
5573397,1525716946,1525716963,17,223,18.14689330016497,20.0,5.0,48.68178627596419
5573398,1525716960,1525716978,18,164,10.006415027496693,5.0,1.0,27.47962526156132
5573399,1525716967,1525716993,26,120,7.415794110072886,2.0,1.0025136238685128,50.0
5573400,1525716993,1525717001,8,176,24.803541548484237,15.0,1.0,56.0
5573401,1525716999,1525717009,10,119,7.24031960565614,4.0,2.0,56.0
5573402,1525717005,1525717018,13,111,3.4344064214525907,2.0,2.0,11.52177328786125
5573403,1525717009,1525717057,48,57,55.865329677403125,56.0,56.0,56.0
5573404,1525717056,1525717065,9,200,7.731767297605635,5.0,2.0,24.0
5573405,1525717061,1525717083,22,109,13.233019610494456,5.0,1.0,48.68178883262793
5573406,1525717078,1525717104,26,155,7.220038488710849,3.3147069310574824,1.0,40.82480893009274
5573407,1525717097,1525717114,17,154,12.526671953578978,6.0,2.0,56.0
5573408,1525717111,1525717158,47,182,18.67968995607349,5.0,2.0,50.0
5573409,1525717159,1525717188,29,165,15.168008447161368,6.0,4.0,50.0
5573410,1525717187,1525717198,11,156,7.273369854779548,4.0,2.0,27.267854864864876
5573411,1525717191,1525717211,20,149,6.658050841042627,2.0,1.0,18.768958755635037
5573412,1525717211,1525717223,12,139,21.271687567708437,9.0,5.0,56.0
5573413,1525717223,1525717241,18,61,56.21134775431965,56.0,56.0,56.0
5573414,1525717239,1525717268,29,200,6.4163648238416435,4.0,2.0,20.223125830258294
5573415,1525717268,1525717277,9,136,26.267913687708948,17.461449549829247,5.005458388550548,56.37334383434897
5573416,1525717277,1525717289,12,135,11.88554191378881,5.378643287037037,1.8684935384615384,39.061597367478385
5573417,1525717288,1525717334,46,107,45.50430813678741,50.0,16.0,56.0
5573418,1525717335,1525717347,12,197,11.036793701587854,6.0,4.0,50.0
5573419,1525717346,1525717355,9,144,19.24202301254354,6.0,2.2036479730941667,50.0
5573420,1525717352,1525717376,24,94,26.130985751696798,22.95349305242248,15.5115,50.0
5573421,1525717374,1525717404,30,164,27.809486284188065,15.899673626404494,1.0,50.0
5573422,1525717387,1525717404,17,144,10.872234888301312,6.0,1.0,28.691835135135065
5573423,1525717401,1525717451,50,94,15.955991702484456,7.241398597036542,5.0,50.0
5573424,1525717451,1525717459,8,161,12.924729566951756,5.53250577911468,4.0,50.0
5573425,1525717452,1525717467,15,124,9.093914477290474,5.245978137931034,2.0,50.0
5573426,1525717458,1525717475,17,101,6.182897157935089,2.612199185856246,1.0,26.362591266497994
5573427,1525717468,1525717485,17,83,16.505714355721597,6.0,1.0,50.0
5573428,1525717481,1525717494,13,196,15.304373183688554,4.989877757487217,3.0,50.0
5573429,1525717493,1525717512,19,120,8.986829578249187,2.0,2.0,50.0
5573430,1525717505,1525717521,16,64,10.072786232868195,4.286665861682243,2.0,50.0
5573431,1525717507,1525717532,25,43,51.7795566386978,50.0,49.893958186121665,70.86742556917686
5573432,1525717531,1525717541,10,152,7.647700819035001,6.0,1.2958920304017374,18.7689402
5573433,1525717538,1525717608,70,141,7.376783951793595,5.0,1.1,32.095457264846
5573434,1525717607,1525717642,35,209,33.35026953451081,41.0,5.0,60.0
5573435,1525717639,1525717664,25,51,9.651676626300667,5.685317305791296,1.0,50.0
5573436,1525717664,1525717681,17,135,19.57111049821037,15.0,5.0,50.0
5573437,1525717673,1525717690,17,182,19.09184945707942,6.0,4.0,50.0
5573438,1525717684,1525717690,6,209,6.98038591821416,3.0,2.0,49.91787619047606
5573439,1525717688,1525717710,22,17,48.502523590621074,50.0,41.0,51.9
5573440,1525717707,1525717718,11,142,7.099165542194674,5.187586343471944,2.0,20.0
5573441,1525717711,1525717739,28,199,8.007751179675266,3.0,3.0,50.0
5573442,1525717728,1525717746,18,49,42.57510251414405,50.0,21.000000000129987,50.026640539479075
5573443,1525717741,1525717754,13,141,7.038585266304671,5.0,2.0,40.4396538120303
5573444,1525717748,1525717777,29,84,4.72943270241937,2.0,1.0,25.75915749999989
5573445,1525717772,1525717804,32,225,12.731125966562777,5.0,1.0,50.0
5573446,1525717802,1525717813,11,254,20.680089715005334,5.6784191968658195,1.0,50.0
5573447,1525717811,1525717835,24,201,10.718709452314748,5.0,3.0,50.0
5573448,1525717829,1525717843,14,94,17.049462021108994,6.0,1.0,58.11250947523584
5573449,1525717836,1525717851,15,37,22.27539445839241,7.781099767981438,1.0,50.0
5573450,1525717848,1525717859,11,278,7.027009367617751,1.0,1.0,50.0
5573451,1525717852,1525717869,17,141,4.465754017157081,2.5,2.0,9.39726201398841
5573452,1525717870,1525717877,7,58,14.47154219417835,6.0,1.0,50.0
5573453,1525717877,1525717917,40,140,7.140607712206321,2.000055687140115,1.0,19.879846117847627
5573454,1525717886,1525717926,40,113,9.876148131461026,5.575835428422,1.0,39.15796168694912
5573455,1525717921,1525717959,38,27,55.372098871042255,50.0,8.750496072757338,145.4374571955719
5573456,1525717957,1525717980,23,221,24.911617706600534,20.0,6.0,50.0
5573457,1525717978,1525718012,34,26,39.828131377587944,41.0,20.0,65.5579276365195
5573458,1525718011,1525718052,41,149,11.181815775905324,6.0,4.0,41.0
5573459,1525718051,1525718061,10,19,50.91433331750535,50.0,20.0,100.0
5573460,1525718060,1525718078,18,142,14.95194929454737,10.0,4.906258088888889,41.0
5573461,1525718066,1525718121,55,129,8.237106582054441,4.0,3.0,41.0
5573462,1525718119,1525718152,33,186,13.572473714485731,6.952619147651486,4.0,50.0
5573463,1525718147,1525718160,13,117,10.914030697982001,6.0,4.0,41.0
5573464,1525718157,1525718170,13,177,6.160130902651564,4.0,2.0002,22.971183703703687
5573465,1525718166,1525718178,12,158,17.036599818588364,6.0,3.0,55.4
5573466,1525718167,1525718178,11,207,4.821400262304409,3.0,3.0,6.624404617785996
5573467,1525718174,1525718190,16,110,3.9994978321631094,2.0,2.0,10.114643316784834
5573468,1525718189,1525718207,18,90,9.373341697639379,4.0,1.0,34.14081563595496
5573469,1525718199,1525718215,16,88,9.22045843290717,4.0,1.0000000655382437,41.0
5573470,1525718207,1525718224,17,69,5.993329164930747,2.073709243977758,1.0000000894859025,20.29845271493212
5573471,1525718215,1525718225,10,154,5.391546596690038,1.0,1.0,26.35538582004983
5573472,1525718223,1525718234,11,15,33.300021742896696,23.994494332064384,20.0,70.6203175438596
5573473,1525718232,1525718255,23,119,5.475483138670491,2.0,2.0,29.312256338028014
5573474,1525718254,1525718263,9,198,15.738619029650588,10.0,3.0,50.0
5573475,1525718260,1525718285,25,65,5.238408147200645,4.0,2.0,15.0
5573476,1525718278,1525718294,16,123,6.322451969572916,2.0119536244014964,2.0,20.0
5573477,1525718282,1525718294,12,67,4.99559768416821,1.0000583709694988,1.0,26.22737176470585
5573478,1525718286,1525718309,23,146,5.856517528199839,1.0,1.0,30.0
5573479,1525718307,1525718328,21,324,7.400472520421042,1.0,1.0,50.0
5573480,1525718320,1525718329,9,177,8.879783611745173,5.0,2.0,41.0
5573481,1525718328,1525718365,37,139,17.766103852130282,6.0,1.0,50.0
5573482,1525718356,1525718388,32,178,16.2740205147701,7.576309999999998,3.0,55.00004930354509
5573483,1525718384,1525718404,20,140,24.418245862141593,15.0,4.0,55.4
5573484,1525718388,1525718404,16,133,2.8796777757493635,2.0,1.0,6.123514825271927
5573485,1525718390,1525718406,16,10,7.83733838116823,7.814742355056606,3.0,11.714518625766871
5573486,1525718402,1525718433,31,98,23.889211749179303,7.6045239484150935,4.0,55.4
5573487,1525718433,1525718443,10,83,43.76685246593449,50.0,20.0,55.4
5573488,1525718440,1525718444,4,157,7.304080455970166,5.536466112741333,3.0,20.0
5573489,1525718441,1525718458,17,7,5.523004325599685,4.268678871845621,4.0,15.221578947368414
5573490,1525718450,1525718468,18,13,49.950518522428254,50.0,41.0,72.73820343063495
5573491,1525718464,1525718475,11,183,7.787956075946251,5.595712071230438,3.0,24.0
5573492,1525718472,1525718484,12,102,3.637081591605817,2.0,1.1441707630057805,6.196706061997704
5573493,1525718476,1525718494,18,89,4.4112160114156795,1.9263656251171204,1.0,6.464285908830274
5573494,1525718494,1525718515,21,192,8.804978382935776,5.0,3.0,50.0
5573495,1525718512,1525718532,20,189,10.335617956971953,5.577681616525057,3.0,50.0
5573496,1525718517,1525718539,22,93,5.088908842393889,5.0,1.4143614340816568,9.639752199999975
5573497,1525718532,1525718549,17,12,48.82001124702951,50.0,41.0,51.0
5573498,1525718534,1525718559,25,131,7.373169736927327,6.0,2.0,16.105378992710374
5573499,1525718548,1525718592,44,69,7.259833515206145,2.0,1.000006388406606,46.708205710238474
5573500,1525718591,1525718606,15,125,9.368603224055905,5.9942047354547725,3.1313028863116092,41.0
5573501,1525718605,1525718619,14,61,55.44272229426441,55.4,55.000000000248306,56.0
5573502,1525718614,1525718619,5,60,54.984363841727536,55.000000001,55.0,55.16209015822519
5573503,1525718618,1525718628,10,121,19.133867800981246,10.0,4.0,49.80485168647975
5573504,1525718622,1525718649,27,59,10.164975403464796,9.076480706921945,2.0,17.522686166329873
5573505,1525718647,1525718660,13,136,27.786095747292485,6.191421366345713,4.0,55.000000001
5573506,1525718659,1525718668,9,124,24.01965139470245,8.847590625000013,2.0,55.000000001
5573507,1525718666,1525718697,31,67,3.685090612362755,2.0,1.0886527130434784,8.080687867177504
5573508,1525718689,1525718707,18,169,7.566254720770332,4.0,1.0,41.0
5573509,1525718704,1525718715,11,57,13.385178109196934,6.0,4.0,50.0
5573510,1525718712,1525718731,19,24,19.420142525906414,19.570653626373627,4.0,39.08362140221402
5573511,1525718722,1525718761,39,207,6.25052932292873,3.0,3.0,22.495802222222196
5573512,1525718728,1525718762,34,218,3.927227025829897,1.0469302900312285,1.0,17.29801066666657
5573513,1525718734,1525718762,28,64,2.8124462913998824,2.0,1.0,6.11429674002751
5573514,1525718744,1525718783,39,170,4.980825966849424,2.0,1.0,15.5115
5573515,1525718780,1525718792,12,193,21.151283215296928,15.0,15.0,50.437963986267896
5573516,1525718792,1525718829,37,162,11.56903018029723,6.0,4.0,21.855790990990982
5573517,1525718827,1525718843,16,161,10.055720894646639,4.010389065391886,2.0,22.0
5573518,1525718842,1525718853,11,167,17.2153848839548,6.0,3.0,50.0
5573519,1525718851,1525718862,11,92,2.8252369298610733,2.0,2.0,4.0
5573520,1525718853,1525718875,22,73,2.5614360856659175,2.0,2.0,4.0
5573521,1525718866,1525718882,16,63,11.203462748385059,6.0,1.0,50.0
5573522,1525718872,1525718882,10,25,12.760470384820762,8.52102380952381,4.0,41.0
5573523,1525718874,1525718889,15,125,3.7356521050846516,2.0,1.0353926726467202,6.0
5573524,1525718882,1525718898,16,186,2.8420544622674284,1.0000005016763265,1.0,6.014235022624431
5573525,1525718893,1525718924,31,104,8.111681541961648,4.0,1.0,22.354697579496914
5573526,1525718903,1525718936,33,47,13.041418424963833,6.0,4.0,50.0
5573527,1525718904,1525718936,32,84,1.9412406744834758,1.0000800192614996,1.0,3.0
5573528,1525718908,1525718937,29,18,26.253194295282878,23.0,15.0,50.0
5573529,1525718917,1525718937,20,105,3.456992359986029,2.0,1.1,10.615706414191923
5573530,1525718931,1525718948,17,154,10.665570663869657,3.0,2.0,50.0
5573531,1525718945,1525719045,100,108,4.093629879490405,1.000056956294786,1.0,12.860678333333274
5573532,1525719045,1525719063,18,168,47.006668963714965,15.00000000068387,5.0,205.31017433251193
5573533,1525719057,1525719070,13,128,7.165066239355669,5.011107139068172,4.0,23.741655283018865
5573534,1525719059,1525719070,11,103,5.362757762625796,2.4853101538461546,2.0,20.0
5573535,1525719064,1525719083,19,136,13.833107149382084,6.569313563218391,2.0,50.0
5573536,1525719082,1525719103,21,125,5.400197232555166,2.0,1.3160240506329115,30.0
5573537,1525719096,1525719103,7,99,9.890271115707089,6.0,2.0,40.87630316404855
5573538,1525719100,1525719119,19,85,2.9652041915097174,1.9485590405904034,1.0,6.389427749999996
5573539,1525719119,1525719130,11,166,8.24405633097121,6.0,1.0,33.6285387096774
5573540,1525719129,1525719150,21,121,5.201852102029408,2.0,2.0,20.0
5573541,1525719148,1525719157,9,80,3.9218311340070886,2.0,2.0,10.420123777777775
5573542,1525719150,1525719165,15,174,9.947824245474408,4.0,1.0,50.0
5573543,1525719158,1525719178,20,75,6.941706055810193,2.0,1.000100001,50.0
5573544,1525719176,1525719186,10,21,34.98296829568229,41.0,0.25,76.75951723364577
5573545,1525719184,1525719208,24,67,29.985124987947703,23.0,15.0,50.0
5573546,1525719206,1525719217,11,186,4.285004722697455,4.0,1.000100001,7.633466789667889
5573547,1525719217,1525719237,20,78,3.676935552614586,2.0,1.000100001,9.246980043956043
5573548,1525719229,1525719246,17,255,3.37703533052335,1.0,1.0,7.899577931034464
5573549,1525719243,1525719270,27,314,5.535955200810459,2.0,2.0,22.498575167627326
5573550,1525719270,1525719294,24,169,9.379096138578284,6.0,3.0,41.0
5573551,1525719293,1525719317,24,87,28.410533953209907,19.63564696969697,14.8147132,50.0
5573552,1525719316,1525719325,9,216,4.407620264496094,4.0,1.0,10.0
5573553,1525719321,1525719335,14,152,3.281105016915405,2.0,1.0,6.133002249479287
5573554,1525719332,1525719342,10,151,7.362767268894916,3.0,1.000100001,50.0
5573555,1525719336,1525719370,34,126,7.458659693886321,3.5,2.0,30.0
5573556,1525719369,1525719388,19,137,9.533122384107314,5.0,2.0,41.0
5573557,1525719387,1525719395,8,106,6.772686645486741,4.0,2.0,20.61975080302909
5573558,1525719395,1525719413,18,45,5.803267556820533,1.0000999017423309,1.0,41.0
5573559,1525719409,1525719420,11,79,8.985167094981767,6.0,2.0,29.324854054053887
5573560,1525719412,1525719431,19,7,15.4704292020892,15.11624828295569,5.099155155013694,19.69914664866999
5573561,1525719432,1525719458,26,121,10.38733370519347,6.0,1.1745588638033935,50.0
5573562,1525719456,1525719465,9,113,13.174138893285178,5.371110548469388,1.0000000419784387,51.9
5573563,1525719461,1525719473,12,135,2.8752655170198853,1.0,1.0,6.1479948305860805
5573564,1525719471,1525719480,9,175,21.587327096727748,15.0,3.0,50.0
5573565,1525719477,1525719481,4,13,52.32044668333051,50.0,41.0,78.262951875
5573566,1525719479,1525719490,11,100,4.222985948651766,2.0,2.0,7.515885651850458
5573567,1525719488,1525719508,20,38,5.1401389944698765,2.0,2.0,8.0
5573568,1525719494,1525719520,26,86,6.737261858228972,1.5,1.0,37.22269463301429
5573569,1525719520,1525719538,18,114,5.765088090489336,1.0,1.0,51.84635211142509
5573570,1525719536,1525719545,9,61,54.9860005340537,55.0,55.0,55.0
5573571,1525719539,1525719570,31,224,14.755921187978776,5.292306352040817,1.0,51.9
5573572,1525719572,1525719614,42,62,54.974531379712126,55.0,55.0,55.0
5573573,1525719614,1525719633,19,213,19.87853731589645,15.683564174074075,4.0,51.92153784210526
5573574,1525719632,1525719641,9,93,18.339068938379864,12.657780952380953,4.0,55.0
5573575,1525719638,1525719651,13,59,54.86666620501686,55.0,55.0,55.0
5573576,1525719650,1525719666,16,83,40.58901664749183,55.0,15.65423245473738,55.0
5573577,1525719664,1525719674,10,214,4.448602421625161,3.0,2.0,8.214192207792191
5573578,1525719669,1525719683,14,173,8.446209571058294,4.0,4.0,50.0
5573579,1525719682,1525719691,9,15,26.99501205271965,25.53945,14.650749120946552,54.33889994442352
5573580,1525719686,1525719699,13,10,22.710434927813928,21.0,18.0,43.677916528925614
5573581,1525719693,1525719710,17,228,3.637167322105286,2.0,1.0,8.764858792855819
5573582,1525719698,1525719734,36,100,2.0558305727732455,1.069386477806442,1.0,2.7551041242718437
5573583,1525719704,1525719742,38,86,4.526066573259936,1.0,1.0,18.025640303030297
5573584,1525719733,1525719751,18,127,11.715010075852586,7.495745983304879,1.0,50.0
5573585,1525719747,1525719761,14,166,14.84981203928898,5.292980529461999,3.0,50.0
5573586,1525719755,1525719775,20,115,3.398942387381084,2.0,2.0,7.524909511687108
5573587,1525719774,1525719785,11,181,10.657024058082555,5.0,3.0,50.0
5573588,1525719784,1525719801,17,61,53.83139332301929,54.0,54.0,54.0
5573589,1525719802,1525719819,17,118,7.669645050663676,4.0,1.0476665113988588,29.266817307692264
5573590,1525719810,1525719829,19,84,27.817530332565475,20.00032519239905,3.0,54.0
5573591,1525719815,1525719849,34,60,53.65441452650706,54.0,54.0,54.0
5573592,1525719820,1525719849,29,109,30.281855262693977,41.0,3.0,54.0
5573593,1525719844,1525719858,14,77,49.66874968202948,54.0,20.0,54.0
5573594,1525719853,1525719886,33,140,4.967203653549344,4.0,1.0,17.04494274198707
5573595,1525719885,1525719904,19,193,10.74047887050149,6.0,3.0,50.0
5573596,1525719898,1525719911,13,206,4.89218007024263,1.0,1.0,24.797199999999947
5573597,1525719909,1525719922,13,94,14.872559761903425,6.0,3.0,50.0
5573598,1525719918,1525719922,4,15,24.06702941811345,19.31303042859382,1.5991088988216173,70.42051666666661
5573599,1525719921,1525719930,9,27,9.666988920568999,5.746601303921569,3.0,25.02757242524917
5573600,1525719925,1525719953,28,59,2.320067194729791,2.0,1.0,2.5493489517102184
5573601,1525719946,1525719966,20,136,9.466605756191372,6.0,2.0,20.92909476348679
5573602,1525719966,1525719974,8,133,8.52913633440888,4.0,2.0,41.991665214921554
5573603,1525719972,1525719982,10,58,9.222200838308128,4.036778447191204,1.0000000325655223,21.308932499999994
5573604,1525719979,1525719989,10,44,15.008999006369086,5.606055,2.0,50.0
5573605,1525719982,1525720016,34,133,3.471530425942647,1.0,1.0,7.002804045293426
5573606,1525719994,1525720026,32,110,5.3122261365834245,3.0,2.0,20.0
5573607,1525720008,1525720033,25,88,7.228742509324589,1.3181120857719868,1.0,50.0
5573608,1525720015,1525720042,27,200,11.09923345447439,4.0,3.0,50.0
5573609,1525720024,1525720057,33,117,4.933485794831694,2.0,1.000100001,20.0
5573610,1525720027,1525720066,39,82,2.833402003101906,2.0,1.0,7.155810321684793
5573611,1525720030,1525720066,36,18,12.001852185877475,6.48577142857143,4.0,43.17913513513509
5573612,1525720034,1525720067,33,51,2.843486436251336,2.0,1.0,6.148519120728929
5573613,1525720059,1525720087,28,160,8.384559777013619,3.7014726190476166,1.0,30.0
5573614,1525720078,1525720122,44,202,8.380408452220829,5.248134694117647,3.0,24.0
5573615,1525720116,1525720140,24,123,9.346687145328099,4.0,2.0,41.0
5573616,1525720132,1525720155,23,132,11.084552959555626,6.0,3.0,50.0
5573617,1525720153,1525720173,20,109,6.019455757469491,3.0,2.0,27.898619819819828
5573618,1525720156,1525720180,24,50,6.0994363490144785,3.70661006484205,2.0,20.661699999999893
5573619,1525720168,1525720189,21,61,3.4893595170075216,2.0,1.0,9.957490666666619
5573620,1525720174,1525720232,58,195,7.475952745589697,3.0,3.0,40.46152265193352
5573621,1525720230,1525720262,32,274,14.448328829734853,6.0,1.0,50.34317020696777
5573622,1525720250,1525720263,13,165,5.414212494314029,3.5,2.0,10.376458874458836
5573623,1525720256,1525720276,20,176,13.57870633465215,5.576997777777778,3.0,51.07505220348294
5573624,1525720268,1525720277,9,269,4.923233160451067,1.0,1.0,34.50843661578908
5573625,1525720271,1525720290,19,77,3.014540852753165,1.1115923461538462,1.0,7.2973891228882195
5573626,1525720281,1525720298,17,204,21.31939442708794,5.276893629213483,1.0,55.0
5573627,1525720293,1525720311,18,72,13.455701358413352,5.790717391304348,3.0,55.0
5573628,1525720296,1525720312,16,79,3.4378502915074924,2.0,1.0,8.826841428571411
5573629,1525720310,1525720339,29,89,12.076442623626896,5.352659941660704,2.0,55.0
5573630,1525720337,1525720391,54,152,18.81206501825746,5.98834663058761,1.0,55.0
5573631,1525720391,1525720407,16,23,56.878838468184156,60.0,9.327709523809524,90.44033140495867
5573632,1525720403,1525720415,12,126,12.87882779886624,6.0,5.0,50.0
5573633,1525720409,1525720425,16,165,4.467003377132412,2.0,2.0,15.0
5573634,1525720415,1525720433,18,144,9.577944640228463,4.0,1.0000494348468,50.0
5573635,1525720421,1525720456,35,146,21.072251157552376,7.801037722749363,1.0,55.0
5573636,1525720455,1525720470,15,166,10.95551436970028,5.0,2.0,41.0
5573637,1525720470,1525720508,38,65,55.875622832985314,55.0,55.0,60.0
5573638,1525720507,1525720525,18,61,55.2905541484612,55.0,55.0,55.0
5573639,1525720519,1525720533,14,181,26.202326381720088,20.0,15.0,55.0
5573640,1525720525,1525720557,32,164,8.124306074742664,5.0,2.0,20.6887172755579
5573641,1525720552,1525720564,12,114,8.820047216601443,8.0,1.0,23.0
5573642,1525720560,1525720578,18,87,6.966812518831176,5.43990557458803,2.114752180094787,23.107024509803907
5573643,1525720577,1525720601,24,177,6.0911759508796415,2.0,1.0,23.285027380952375
5573644,1525720599,1525720621,22,102,7.981071764444178,4.0,1.0,50.0
5573645,1525720622,1525720634,12,138,17.650455367690995,6.984359518348624,4.0,51.9
5573646,1525720634,1525720643,9,21,40.80303943220871,41.0,30.0,50.0
5573647,1525720639,1525720651,12,175,5.74565228065835,4.0,1.0,17.547838039215684
5573648,1525720646,1525720657,11,88,3.6261104597593286,2.0,1.0,7.899223148936168
5573649,1525720650,1525720699,49,114,32.66683353185156,30.0,13.0,50.0
5573650,1525720701,1525720706,5,124,6.194926684468816,5.0,1.0,10.0
5573651,1525720704,1525720716,12,108,3.5679933224982956,3.0,2.0,7.226871742652163
5573652,1525720715,1525720723,8,211,9.83831614771833,4.0,3.0,50.0
5573653,1525720720,1525720730,10,208,3.6536865044318194,3.0,3.0,6.01122184093443
5573654,1525720723,1525720738,15,261,1.3323335331355983,1.0,1.0,2.0
5573655,1525720729,1525720756,27,111,7.54280788693575,6.0,3.0,41.0
5573656,1525720756,1525720764,8,181,8.991192232459959,4.9304934399999905,1.0,40.612112124831626
5573657,1525720759,1525720772,13,80,3.1026180638057577,2.0,2.0,5.0
5573658,1525720766,1525720780,14,71,2.0189241255425086,2.0,1.0,2.598614653601369
5573659,1525720771,1525720780,9,149,11.535692865876157,4.0,3.0,50.0
5573660,1525720775,1525720788,13,54,3.9488841943667703,2.0,1.0,16.70045656174588
5573661,1525720782,1525720799,17,108,5.152126051296555,2.0,1.0946923333333334,20.425595338179356
5573662,1525720794,1525720818,24,121,9.891841609319957,5.708799131348706,2.0,40.849293555794596
5573663,1525720801,1525720818,17,39,2.9150224903281643,1.000001,1.0,17.015868867924524
5573664,1525720806,1525720819,13,68,4.5747247465184175,2.0,1.0,17.991129607843135
5573665,1525720816,1525720837,21,87,6.601100422384528,2.0,1.0,50.0
5573666,1525720838,1525720849,11,124,11.961205338164238,5.990670390355913,3.0,50.0
5573667,1525720847,1525720856,9,93,5.838949744071085,2.0,1.0,24.022359999999956
5573668,1525720853,1525720864,11,71,51.16009097478307,54.000000001,23.5,54.000000001
5573669,1525720863,1525720872,9,24,6.132795443758899,5.059493670886076,4.0,11.449999999999992
5573670,1525720872,1525720880,8,75,50.871408380200606,54.4407993486119,18.0,55.0
5573671,1525720875,1525720888,13,115,3.616123490507284,2.0,1.0,6.026042059835699
5573672,1525720876,1525720889,13,41,5.355865758518068,2.0,1.0,55.0
5573673,1525720889,1525720912,23,74,75.64250621174418,55.0,0.0,81.19577414307061
5573674,1525720909,1525720920,11,63,55.18370096202245,55.0,55.0,55.0
5573675,1525720911,1525720938,27,172,14.319009123655087,4.0,1.5,41.0
5573676,1525720935,1525720946,11,117,10.086983902188583,4.0,1.0,50.0
5573677,1525720942,1525720954,12,67,3.8247404666410176,2.0,2.0,13.07331741036793
5573678,1525720947,1525720961,14,72,6.77254790990947,1.0,1.0,45.97224631115705
5573679,1525720954,1525720968,14,210,6.909179473177163,3.0,3.0,23.5
5573680,1525720961,1525720996,35,73,5.687730898465504,2.0,1.0,41.0
5573681,1525720994,1525721017,23,158,14.869605622216291,6.0,3.0,53.35461885929955
5573682,1525721009,1525721029,20,142,7.342434616900999,2.002,1.0,54.18261323793374
5573683,1525721029,1525721046,17,191,19.715439040850207,6.0,3.0,50.0
5573684,1525721044,1525721068,24,91,4.918616443715356,1.0,1.0,23.054820621317162
5573685,1525721059,1525721068,9,72,4.54419265293321,2.0,2.0,15.0
5573686,1525721062,1525721082,20,167,15.796671253825243,3.0,1.0,50.0
5573687,1525721072,1525721089,17,210,8.771750777303904,3.0,3.0,50.0
5573688,1525721076,1525721098,22,99,1.843333252828765,1.0000008637885713,1.0,2.0541858813793086
5573689,1525721087,1525721099,12,205,8.288951291739728,3.0,3.0,33.195788370874695
5573690,1525721091,1525721099,8,114,1.8698546686392905,2.0,1.0,3.728870007999999
5573691,1525721094,1525721136,42,55,1.4128151161096782,1.0,0.8013534410072595,2.0
5573692,1525721135,1525721178,43,154,7.363684171600852,4.0,2.0,30.0
5573693,1525721177,1525721190,13,217,13.477877813164204,6.0,1.0,50.0
5573694,1525721188,1525721198,10,218,4.533860566604149,3.0,1.0,16.658792912249734
5573695,1525721193,1525721208,15,116,6.7318079346228386,4.0,3.0,17.65193181541553
5573696,1525721201,1525721208,7,115,6.41834694824493,3.0,1.0,30.293730980037854
5573697,1525721204,1525721209,5,178,2.0914261934606744,2.0,1.0,4.855925857002938
