block_number,block_timestamp,my_timestamp,timestamp_delta,tx_count,avg_gas_price,median_gas_price,q5_gas_price,q95_gas_price
5467057,1524120829,1524120835,6,158,47.08798686454581,21.0,2.0,140.0
5467058,1524120833,1524120841,8,166,10.124696270171908,4.0,2.0,40.0
5467059,1524120840,1524120867,27,89,6.835585155541419,4.0,2.0,36.61291931034482
5467060,1524120859,1524120872,13,159,13.768053425238726,5.0,2.0,50.0
5467061,1524120866,1524120882,16,14,15.470823763113787,4.0,4.0,50.0
5467062,1524120879,1524120896,17,187,11.045804784841339,3.023547837302983,2.0,50.0
5467063,1524120895,1524120901,6,58,59.71511618227899,50.0,41.37751401088798,91.0
5467064,1524120898,1524120919,21,121,4.249258300038951,4.0,2.0,11.637648758476919
5467065,1524120918,1524120926,8,111,14.35280443054696,4.023249596775568,2.0,50.0
5467066,1524120926,1524120937,11,60,13.530727713299209,5.000610786363636,3.0,50.0
5467067,1524120935,1524120944,9,118,11.97475276231014,3.0,2.0,49.647743559332156
5467068,1524120943,1524120977,34,134,13.064205588811207,4.0,1.0,50.0
5467069,1524120977,1524121011,34,209,13.901631317847812,5.0,2.0,50.0
5467070,1524121010,1524121022,12,172,19.834716088805692,8.0,1.0,50.0
5467071,1524121022,1524121026,4,118,14.696336187219993,5.0,2.0,50.0
5467073,1524121033,1524121043,10,127,8.273186083578345,4.0,2.0,30.133348677248676
5467074,1524121035,1524121062,27,96,7.832744411889289,3.225534735416354,2.0,50.0
5467075,1524121061,1524121067,6,144,11.47803610780953,4.0,2.0,50.0
5467076,1524121066,1524121099,33,91,17.134743367620782,3.6225727069185756,2.2,91.0
5467077,1524121100,1524121112,12,139,28.78860205434692,20.0,5.0,55.0
5467078,1524121112,1524121121,9,95,7.525900387519466,5.0,4.0,20.223716071428573
5467080,1524121127,1524121135,8,215,3.3467353371438433,2.0,2.0,4.18260539280742
5467081,1524121132,1524121137,5,267,5.720192948742667,2.0,1.0,41.331463157894554
5467082,1524121136,1524121145,9,117,13.019354984305263,4.0,2.0,50.0
5467083,1524121142,1524121160,18,183,7.787521347755215,3.0,2.0,50.0
5467084,1524121160,1524121178,18,190,11.945564824388294,4.0,2.0,50.0
5467085,1524121175,1524121190,15,170,10.106286584363097,3.0,2.0,41.23689198947743
5467086,1524121190,1524121206,16,227,14.74636489126413,4.0,1.0,50.0
5467087,1524121205,1524121256,51,177,11.957992336665898,3.0,2.0,55.35010193637603
5467088,1524121257,1524121275,18,293,19.829412007465372,12.0,5.0,69.89204271908736
5467089,1524121273,1524121303,30,204,10.011387003204081,4.0,3.0,50.85959867857141
5467090,1524121302,1524121307,5,200,13.063623556259133,5.0,2.0,51.9
5467091,1524121307,1524121317,10,162,52.84373245092238,55.0,31.09849473684211,55.0
5467092,1524121316,1524121326,10,86,10.902610859342747,4.0,4.0,55.0
5467093,1524121327,1524121342,15,120,11.083497163352849,4.0,2.0,52.76710633484159
5467094,1524121341,1524121374,33,127,9.441486223727747,4.0,2.0,45.38753050949377
5467095,1524121373,1524121391,18,148,20.882888985062927,10.0,2.0,60.05460037735849
5467096,1524121390,1524121408,18,121,13.916294152759665,5.0,2.039555114503817,50.90059072330059
5467097,1524121407,1524121414,7,124,14.889986954343028,4.0,2.0,50.77639807431514
5467098,1524121413,1524121419,6,117,7.941989380228158,4.0,2.0,40.0
5467099,1524121419,1524121437,18,98,7.981170492075936,4.0,2.0,29.900364857142787
5467100,1524121436,1524121445,9,152,30.54065768928039,21.09334139936481,5.001,55.0
5467101,1524121443,1524121466,23,84,5.954608209675109,4.0,2.0,7.43522222222222
5467102,1524121466,1524121493,27,127,10.096392798662874,4.0,3.0,50.0
5467103,1524121492,1524121531,39,136,15.191115083427198,4.909049014084507,3.0,52.768858752352074
5467104,1524121529,1524121536,7,192,9.676254085301878,5.0,2.0,50.0
5467105,1524121536,1524121551,15,191,7.144141006467981,2.0,1.0,50.0
5467106,1524121550,1524121556,6,161,6.001510467090888,4.0,1.5,20.0
5467107,1524121556,1524121561,5,113,7.238958026694702,4.0,2.0,40.0
5467108,1524121561,1524121567,6,174,19.60208736755553,4.0,3.681587068560907,55.0
5467109,1524121567,1524121580,13,112,5.121327753137143,3.0,2.0,5.815200895541082
5467110,1524121578,1524121584,6,157,4.685235854946498,3.0,2.0,5.107754780442478
5467111,1524121582,1524121588,6,40,45.1482651357684,50.0,23.282775863138898,60.0
5467112,1524121584,1524121590,6,196,5.051555133468555,4.0,2.0,17.110717971986094
5467113,1524121589,1524121597,8,155,4.459731551085317,2.0,2.0,16.57015999999992
5467114,1524121594,1524121626,32,206,4.9396813210799255,3.0,2.0,6.463153108453101
5467115,1524121627,1524121637,10,180,17.031851559777472,5.0,4.0,51.33422289257938
5467116,1524121636,1524121642,6,154,5.768121091402756,3.0,2.0,19.326337434057727
5467117,1524121640,1524121684,44,185,6.0209634433029455,3.0,2.0,19.561323478260867
5467118,1524121684,1524121748,64,216,12.922180694438563,5.0,3.0,50.0
5467119,1524121748,1524121772,24,204,48.17689877540975,50.0,15.0,91.0
5467120,1524121771,1524121815,44,143,11.923177131251284,5.0,5.0,43.145394805536675
5467121,1524121815,1524121826,11,191,13.561307409829372,5.0,5.0,50.06129544073555
5467122,1524121825,1524121845,20,192,7.624520737940852,4.0,3.0,40.72667399999999
5467123,1524121844,1524121908,64,150,31.9438098425472,21.0,5.0,100.0
5467124,1524121906,1524121917,11,187,24.17396353793318,14.589196574083708,5.0,55.933771145484044
5467125,1524121916,1524121921,5,119,17.819561755180356,5.0,5.0,55.0
5467126,1524121919,1524121976,57,261,5.377110935114518,4.0,1.0,5.0
5467127,1524121975,1524121979,4,199,15.299637882055526,5.0,4.0,60.0
5467128,1524121979,1524122012,33,42,56.11852414286804,55.0,30.0,91.0
5467129,1524122012,1524122080,68,173,12.936962104726467,5.0,4.0,49.760003401360535
5467130,1524122078,1524122095,17,149,25.278005614823996,15.362475000000002,5.0,53.62893817180414
5467131,1524122095,1524122111,16,175,9.243141961387439,5.0,4.0,20.758768027210884
5467132,1524122110,1524122134,24,69,13.392308777014133,5.0,4.0,52.15312164948453
5467133,1524122133,1524122139,6,132,12.406553169204745,5.0,4.0,50.0
5467134,1524122138,1524122144,6,76,5.023852849775426,3.4303113437500006,3.0,11.744506146649389
5467135,1524122142,1524122147,5,154,3.952821330319835,3.0,2.0,5.0
5467136,1524122147,1524122158,11,104,59.08491406032061,55.0,44.87830700000001,100.0
5467137,1524122153,1524122175,22,95,6.651017202344861,5.0,3.0,22.112940170118637
5467138,1524122175,1524122195,20,150,10.523727557496747,5.0,3.0,41.0
5467139,1524122194,1524122210,16,154,14.446004449475277,5.0,4.0,55.0
5467140,1524122209,1524122212,3,123,6.995886031563478,4.0,2.0,31.8609257747415
5467141,1524122211,1524122220,9,81,6.366350182881848,4.0,2.0,21.617712827586114
5467142,1524122220,1524122240,20,112,20.17840389123632,5.0,5.0,55.0
5467143,1524122239,1524122258,19,137,7.252062705676969,4.6,4.0,27.633115999999855
5467144,1524122256,1524122272,16,135,9.20051230780115,4.0,2.0,42.41638691778778
5467145,1524122272,1524122283,11,163,18.87926713011245,5.0,5.0,55.0
5467146,1524122282,1524122286,4,116,12.642148629118346,5.0,5.0,50.0
5467147,1524122286,1524122290,4,261,5.044570659239359,4.0,1.0,10.218316697118444
5467148,1524122289,1524122297,8,99,4.0720023751261385,4.0,2.0,8.537495875057488
5467149,1524122296,1524122306,10,123,6.505731658275692,4.0,2.2,21.0
5467150,1524122306,1524122315,9,126,7.489516018869757,4.0,2.0,31.8
5467151,1524122314,1524122321,7,120,4.836320289033275,4.0,2.0,5.0
5467152,1524122319,1524122326,7,180,13.11160451983822,5.0,2.0,40.749588867143196
5467153,1524122324,1524122329,5,110,9.122337240651444,3.0,3.0,51.540064769600924
5467154,1524122328,1524122348,20,108,13.461505982368838,6.0,2.0,48.4647233584762
5467155,1524122347,1524122354,7,149,37.22801165118699,5.0,3.0,140.0
5467156,1524122354,1524122361,7,132,8.470120310520594,4.0,1.1,49.909451660516595
5467157,1524122360,1524122381,21,110,4.837905069283691,4.0,2.0,13.259230987232241
5467158,1524122380,1524122395,15,63,45.660538403605635,50.0,20.0,90.61349179636498
5467159,1524122394,1524122402,8,213,10.690836941188467,5.0,3.0,50.0
5467160,1524122399,1524122414,15,59,9.582333280349372,4.0,2.2,50.0
5467161,1524122407,1524122422,15,179,3.664921206606099,3.0,2.0,5.0
5467162,1524122415,1524122428,13,214,11.282408124063693,4.0,2.0,50.0
5467163,1524122425,1524122448,23,209,8.314720381171778,3.0,2.0,50.0
5467164,1524122447,1524122460,13,180,12.416631743595932,4.0,2.0,51.41357800687284
5467165,1524122458,1524122518,60,162,7.844169767288378,4.0,2.0,24.0
5467166,1524122519,1524122528,9,194,21.111874924524646,8.357688862897017,4.0,60.0
5467167,1524122527,1524122535,8,135,8.749259707910543,4.0,3.0,50.0
5467168,1524122534,1524122566,32,118,3.8923961723159706,3.0,2.0,6.130501562499954
5467169,1524122565,1524122590,25,127,17.053520747148404,5.0,4.0,51.447454471428564
5467170,1524122590,1524122594,4,190,56.29067837626346,55.0,50.0,91.0
5467171,1524122593,1524122643,50,183,15.025137120817636,5.0,4.0,50.0
5467172,1524122646,1524122652,6,175,17.199096419915822,8.0,4.0,55.0
5467173,1524122651,1524122671,20,117,9.88938827415511,4.0,2.0,20.825818710691824
5467174,1524122670,1524122682,12,98,3.329436717365813,3.8232643240919923,2.0,4.0
5467175,1524122680,1524122687,7,235,11.074193431456578,5.0,1.0,50.0
5467176,1524122686,1524122718,32,131,8.323133657100684,4.0,3.0,50.0
5467177,1524122717,1524122738,21,177,13.985077815522963,5.0,2.0,56.83578625
5467178,1524122737,1524122751,14,117,11.40067871727544,4.0,3.0,50.0
5467179,1524122752,1524122771,19,136,10.237008552151746,4.0,3.0,31.42926217424386
5467180,1524122770,1524122779,9,174,14.056271852126528,5.0,2.0,50.0
5467181,1524122778,1524122785,7,137,11.486622628311062,4.0,3.0,50.0
5467182,1524122785,1524122796,11,64,42.84431908635751,50.0,15.836237704558505,55.0
5467183,1524122796,1524122809,13,124,5.989418989419221,4.0,2.0,20.0
5467184,1524122809,1524122815,6,114,14.152621101756537,5.0,3.0,50.0
5467185,1524122814,1524122833,19,116,7.02413769458198,3.7190342532969747,2.0,23.24784134701774
5467186,1524122833,1524122843,10,165,12.444688257863957,5.0,2.0,49.90831587857473
5467187,1524122842,1524122867,25,134,30.91141633906206,28.932426138117687,4.0,91.0
5467188,1524122867,1524122881,14,213,17.816286647686447,6.567567641129031,1.1,55.0
5467189,1524122879,1524122885,6,120,13.336806226887765,4.0,2.0,64.26056821019283
5467190,1524122883,1524122928,45,115,9.24075070045304,4.040304154862593,2.0,19.90367601526988
5467191,1524122927,1524122934,7,202,9.934701577260565,4.0,2.0,48.85069478610523
5467192,1524122932,1524122963,31,120,6.244870312045493,4.0,2.0,32.62031627906976
5467193,1524122963,1524122971,8,264,10.76853652205158,4.0,1.0,50.0
5467194,1524122966,1524122986,20,110,7.249603078676625,3.0,2.002,21.091521752738654
5467195,1524122985,1524122994,9,149,9.800185611791894,5.0,3.0,41.0
5467196,1524122992,1524122999,7,125,6.144333304824529,4.0,3.0,19.40180180180179
5467197,1524122997,1524123008,11,139,4.953334200433048,4.0,3.0,4.0
5467198,1524123007,1524123015,8,182,31.917371828183306,44.171475219325394,4.0,55.0
5467199,1524123015,1524123033,18,57,9.26490102267133,6.760370735689785,2.0,24.0
5467200,1524123032,1524123045,13,276,8.431589966969842,5.0,2.0,50.0
5467201,1524123046,1524123055,9,210,10.37991883364448,4.0,3.0,51.9
5467202,1524123056,1524123074,18,262,4.711813049726462,2.0,1.0,22.732637037037033
5467203,1524123074,1524123081,7,168,5.627699731536826,3.0,2.0,19.68000955350653
5467204,1524123078,1524123118,40,167,6.216921327690824,3.0,2.0,15.0
5467205,1524123118,1524123127,9,186,39.86900050793941,50.0,5.0,102.0
5467206,1524123123,1524123137,14,159,4.7751857337948085,3.0,2.0,7.730753117536767
5467207,1524123136,1524123142,6,186,37.730399396536704,5.0,2.0,100.0
5467208,1524123142,1524123152,10,225,23.467832980676445,16.50532193038304,3.0,100.0
5467209,1524123146,1524123156,10,239,25.13505562490746,3.0,1.1,106.59990594655919
5467210,1524123156,1524123171,15,179,6.717916532507012,3.0,2.0,27.61996377883989
5467211,1524123170,1524123182,12,160,18.79987523119877,5.0,2.0,99.54000331125826
5467212,1524123181,1524123187,6,272,11.22624792993723,3.0,1.0,50.0
5467213,1524123184,1524123192,8,173,9.57967917903877,3.0,2.0,37.941084003993886
5467214,1524123189,1524123208,19,65,17.194067685096048,8.124731520628726,2.0,49.76809050866858
5467215,1524123207,1524123216,9,224,10.088797532482307,4.0,2.0,50.0
5467216,1524123215,1524123229,14,326,4.4971520664088445,1.0,1.0,17.806495833333194
5467217,1524123222,1524123231,9,151,2.995613133367626,2.0,2.0,4.0
5467218,1524123230,1524123244,14,219,31.790739136531013,10.0,3.0,112.0
5467219,1524123243,1524123251,8,43,43.53128989195998,40.89039678753383,18.041073625684305,100.0
5467220,1524123251,1524123274,23,201,6.435840613028301,3.0000000004019047,2.0,10.226540591199093
5467221,1524123276,1524123292,16,188,20.13539453097812,14.122277358612843,4.0,55.0
5467222,1524123290,1524123311,21,164,12.938684249020882,5.0,3.0,55.0
5467223,1524123310,1524123315,5,54,13.626461887235822,5.0,1.0,50.0
5467224,1524123314,1524123318,4,204,20.57482847338307,5.0,3.0,55.0
5467225,1524123318,1524123328,10,11,6.048086672715911,3.0,3.0,35.17103622222223
5467226,1524123327,1524123351,24,203,10.130271105472602,2.4530470774868185,2.0,54.70801999347754
5467227,1524123350,1524123360,10,178,42.7022869601139,40.87983194156672,4.0,100.0
5467228,1524123356,1524123362,6,227,15.477437977637468,16.910833333333343,3.0,50.0
5467229,1524123361,1524123389,28,210,2.3949444535773363,3.0,1.0,3.0
5467230,1524123386,1524123401,15,213,43.23339035212283,16.841516129032257,1.0,100.0
5467231,1524123397,1524123415,18,161,21.24710346502705,8.027596480108198,3.0,55.0
5467232,1524123415,1524123422,7,52,76.72383933009245,99.27087283614864,30.804739423004943,100.0
5467233,1524123421,1524123426,5,235,6.774586168267007,3.0698117769992836,1.0,18.921964444444377
5467234,1524123425,1524123463,38,47,9.951808591861615,4.835079620334266,4.0,46.21537651873458
5467235,1524123462,1524123499,37,273,35.355392425462995,17.067030264805837,1.0,100.0
5467236,1524123498,1524123523,25,186,15.017316979903507,5.0,4.0,58.15627158671585
5467237,1524123523,1524123528,5,172,13.1617685164356,5.0,4.0,47.146256900212244
5467238,1524123527,1524123555,28,317,6.269902259458567,1.0,1.0,45.280415498154966
5467239,1524123555,1524123564,9,219,17.696206410794048,5.0,4.0,91.0
5467240,1524123563,1524123578,15,190,3.7077932227626134,3.0,2.002,4.811638765665649
5467241,1524123577,1524123610,33,120,51.90058605323239,55.0,30.0,55.0
5467242,1524123609,1524123615,6,280,10.993358323067216,5.0,1.0,50.0
5467243,1524123614,1524123622,8,148,12.713610188629968,5.0,4.0,55.0
5467244,1524123621,1524123662,41,58,14.537736221818607,5.0,4.0,55.0
5467245,1524123661,1524123677,16,202,16.765856729555253,5.0,4.0,55.0
5467246,1524123676,1524123685,9,206,12.236180532784788,4.0,2.0,50.0
5467247,1524123684,1524123710,26,213,41.68755480276903,50.0,4.0,112.0
5467248,1524123708,1524123718,10,219,19.90176010099903,20.0,3.0,59.218549603174544
5467249,1524123718,1524123739,21,142,21.829218447592186,9.950089629629623,3.0,55.0
5467250,1524123738,1524123749,11,247,11.971773520476267,4.0,3.0,50.0
5467251,1524123748,1524123766,18,224,9.713118953983532,4.0,1.0,55.0
5467252,1524123764,1524123773,9,221,15.710035822348305,5.0,3.0,55.0
5467253,1524123773,1524123795,22,204,12.793227815817907,5.0,3.0,50.0
5467254,1524123795,1524123804,9,125,21.541203488577796,10.41964814814815,4.0,52.22530397120928
5467255,1524123803,1524123862,59,33,33.5125605346026,50.0,0.0,55.0
5467256,1524123862,1524123888,26,271,25.962186760556158,21.5331951927745,1.0,57.1353690218349
5467257,1524123886,1524123892,6,142,15.057858552255224,8.451175490011607,4.1,50.0
5467258,1524123889,1524123895,6,165,12.660013875789895,5.284098922624878,3.0,27.663844387990757
5467259,1524123895,1524123902,7,127,6.774421017392766,3.0,2.0,31.284823288888887
5467260,1524123900,1524123907,7,174,6.529470430907775,3.0,2.0,30.49206787330315
5467261,1524123904,1524123924,20,188,7.609471412096464,2.0,2.0,38.6567181174089
5467262,1524123910,1524123939,29,201,6.799710307641994,3.0,1.0,30.0
5467263,1524123929,1524123954,25,211,10.409336703437372,3.327306977198674,2.0,31.09876069565216
5467264,1524123953,1524123974,21,219,49.85586483921876,50.0,30.0,91.0
5467265,1524123965,1524124000,35,144,10.28034344510491,5.0,4.0,40.0
5467266,1524123999,1524124010,11,151,26.92233318838777,17.0,5.0,55.0
5467267,1524124008,1524124013,5,154,9.840100286548354,4.0,4.0,20.978898291409585
5467268,1524124011,1524124027,16,189,4.478091145603046,3.0,2.002,13.610333224913127
5467269,1524124028,1524124044,16,37,53.56366235184531,55.0,23.870083876253272,88.1256036036035
5467270,1524124038,1524124061,23,211,8.715440880095628,5.0,3.0,35.0
5467271,1524124063,1524124079,16,209,12.529639889614929,4.0,3.0,59.80097818691769
5467272,1524124078,1524124093,15,159,25.619719794048383,5.0,4.0,55.0
5467273,1524124087,1524124096,9,174,7.689925033389117,3.0,2.0,50.0
5467274,1524124096,1524124123,27,218,6.47021146316158,3.0,2.0,39.097552469135756
5467275,1524124105,1524124135,30,105,6.699767441361273,4.2526463136166175,2.0,21.980952941176316
5467276,1524124115,1524124154,39,157,16.951103165289855,4.966593030303031,4.0,55.0
5467277,1524124152,1524124173,21,173,22.08477987430964,6.0,4.0,98.40945651315789
5467278,1524124172,1524124179,7,137,9.75141347100932,4.0,3.0,20.905048584131077
5467279,1524124179,1524124188,9,68,44.93859298889417,50.0,18.0,85.65257170504154
5467280,1524124182,1524124206,24,94,12.62758133459926,8.454004713607452,4.0,55.0
5467281,1524124206,1524124227,21,207,9.197836590665373,4.0,3.0,50.0
5467282,1524124226,1524124238,12,256,11.225148588812006,4.0,1.0,50.0
5467283,1524124228,1524124242,14,103,6.505390140913333,4.0,3.0,22.210498765432078
5467284,1524124233,1524124258,25,379,1.032186459489456,1.0,1.0,1.0
5467285,1524124255,1524124286,31,286,9.067287840096828,3.0,1.0,50.0
5467286,1524124286,1524124306,20,177,31.716044636418108,20.397903867003976,5.0,55.0
5467287,1524124305,1524124309,4,55,24.86362734699965,20.0,7.451797402597407,59.286274427131055
5467288,1524124309,1524124312,3,28,51.407650015326595,50.0,41.0,55.0
5467289,1524124311,1524124339,28,210,8.773018315668928,4.991534573341968,4.0,20.04126514380715
5467290,1524124337,1524124343,6,212,17.09178055099094,10.653699220633131,3.0,55.0
5467291,1524124342,1524124351,9,227,11.015171506558698,3.0,1.0,55.0
5467292,1524124348,1524124364,16,180,18.014576541458524,14.179753473905663,3.0,50.0
5467293,1524124363,1524124409,46,5,4.0,4.0,4.0,4.0
5467294,1524124410,1524124423,13,215,33.424550396607124,20.0,17.0,55.0
5467295,1524124421,1524124436,15,248,6.7125562641041325,5.0,1.0,20.0
5467296,1524124436,1524124442,6,102,17.79781484725898,11.042641147347384,4.0,55.0
5467297,1524124443,1524124457,14,66,3.6664741703963957,3.8807754356498005,0.29148861218555094,5.0
5467298,1524124456,1524124466,10,125,16.80297050288619,4.0,3.0,52.48787821575375
5467299,1524124465,1524124473,8,115,21.100891625985565,4.0,4.0,90.60119939505731
5467300,1524124471,1524124530,59,123,5.940789816745437,4.0,3.0,11.352930849053676
5467301,1524124529,1524124534,5,173,18.024577620158794,5.370299924356114,3.0,60.467144723902926
5467302,1524124534,1524124540,6,378,1.0445127444226592,1.0,1.0,1.0
5467303,1524124540,1524124554,14,187,27.833643576050395,20.0,3.0,55.0
5467304,1524124554,1524124578,24,165,13.683980548226227,4.0,1.0,50.0
5467305,1524124578,1524124592,14,63,31.56986527053824,20.0,18.16846544600939,50.0
5467306,1524124592,1524124639,47,200,11.688649164228627,5.0,4.0,55.0
5467307,1524124638,1524124657,19,152,17.756275231616822,5.0,1.0,55.60357265882584
5467308,1524124657,1524124670,13,166,9.288428936345266,4.0,3.0,48.76177230024274
5467309,1524124671,1524124692,21,105,11.728520912957018,4.0,3.0,29.476201842422018
5467310,1524124692,1524124704,12,203,20.087649465401583,8.027104722571067,4.0,55.0
5467311,1524124703,1524124710,7,101,20.43123817362949,8.0,4.0,57.52763149672993
5467312,1524124708,1524124720,12,61,25.3205070705761,7.9732051266678745,4.0,55.0
5467313,1524124719,1524124744,25,97,16.69384372945174,9.232959559008696,3.0,48.68774445037856
5467314,1524124743,1524124746,3,181,10.00029096509721,4.0,3.0,41.0
5467315,1524124745,1524124757,12,12,49.42466151536087,50.0,25.366614414414414,77.37319143111353
5467316,1524124757,1524124770,13,86,8.664352983126903,4.0,3.0,39.962203445174225
5467317,1524124770,1524124787,17,268,10.041563738374178,3.0,1.0,50.0
5467318,1524124785,1524124798,13,97,10.672036317104116,4.0,2.2,42.381798824218606
5467319,1524124798,1524124830,32,101,11.318192850901115,3.0,2.0,50.0
5467320,1524124830,1524124845,15,104,15.91945546318204,4.0,2.2,77.80255199999993
5467321,1524124845,1524124890,45,247,31.79131867557734,20.0,5.0,91.0
5467322,1524124889,1524124902,13,251,25.355049641334215,14.911081640625,5.0,99.38367152317879
5467323,1524124900,1524124906,6,176,13.435325321093702,5.0,3.0,50.0
5467324,1524124907,1524124930,23,230,7.080155252225625,3.0,1.0,50.0
5467325,1524124930,1524124939,9,188,53.31715487244322,50.0,28.27659409594096,100.0
5467326,1524124938,1524124951,13,58,29.502479375343714,20.0,15.787598378378378,50.0
5467327,1524124950,1524124958,8,380,1.0542406831479627,1.0,1.0,1.0
5467328,1524124957,1524124964,7,166,16.155453133165476,5.0,4.0,50.41345016497535
5467329,1524124965,1524124973,8,104,5.13760996298085,4.0,1.0,10.840013180297223
5467330,1524124972,1524124993,21,124,13.827687122135623,4.2133566009739,3.0,50.0
5467331,1524124991,1524125021,30,123,11.31876293294177,4.0,2.0,50.0
5467332,1524125021,1524125068,47,198,39.95511095956086,50.0,8.758446591100352,55.0
5467333,1524125068,1524125080,12,119,44.12362324379256,7.125204066834803,5.0,90.99278742857143
5467334,1524125079,1524125100,21,98,17.290704922959545,5.0,4.0,53.8161556064073
5467335,1524125099,1524125105,6,339,7.4429033948241985,1.0,1.0,50.0
5467336,1524125104,1524125120,16,61,13.121797706570883,5.0,4.0,50.0
5467337,1524125120,1524125125,5,97,12.319363469029645,5.0,4.0,50.0
5467338,1524125125,1524125147,22,79,39.00421987312285,50.0,0.0,55.0
5467339,1524125146,1524125199,53,129,10.682672216671254,5.0,1.0,50.0
5467340,1524125198,1524125211,13,189,53.85270819722646,50.0,50.0,61.323920435967295
5467341,1524125211,1524125233,22,180,12.959505162934896,5.0,4.0,50.0
5467342,1524125233,1524125252,19,195,13.790495482537473,4.874058348623853,4.0,50.0
5467343,1524125250,1524125277,27,116,9.544631513660566,4.0,1.0,50.0
5467344,1524125277,1524125295,18,200,25.185008189557937,20.0,4.0,55.0
5467345,1524125293,1524125307,14,261,7.059591980666598,4.0,1.0,48.395258139534754
5467346,1524125308,1524125314,6,175,16.95007061316473,5.0,4.0,55.0
5467347,1524125313,1524125326,13,119,6.649549711656954,4.0,3.0,50.0
5467348,1524125325,1524125353,28,43,25.86257209941724,20.0,0.0,50.0
5467349,1524125350,1524125357,7,68,40.71346868380085,50.0,19.06896862745098,73.26445704512359
5467350,1524125355,1524125365,10,146,5.715101077744524,5.0,1.0,10.375084763256208
5467351,1524125363,1524125379,16,128,6.547509309481029,4.0,2.366488534842569,38.41972091240427
5467352,1524125378,1524125386,8,129,21.17930010240987,6.203568876704007,4.0,55.0
5467353,1524125387,1524125410,23,153,5.724764224732122,3.0,2.0,33.43575225225208
5467354,1524125409,1524125436,27,202,14.415001026434348,5.0,3.0,51.499373641304345
5467355,1524125435,1524125443,8,173,9.365166336962343,4.0,2.0,50.0
5467356,1524125445,1524125458,13,255,7.291330995241136,3.0,0.25,50.0
5467357,1524125459,1524125471,12,60,37.54270893509517,39.88585,16.182006673177085,55.67160915135252
5467358,1524125465,1524125474,9,140,6.907208644198527,5.0,2.0,17.444745054944942
5467359,1524125471,1524125488,17,185,8.220617742043558,4.0,3.0,55.0
5467360,1524125488,1524125503,15,103,9.64841457657034,2.0,2.0,50.0
5467361,1524125502,1524125513,11,48,25.474668507418297,9.733428899997401,4.0,89.35655065770898
5467362,1524125513,1524125528,15,130,9.059641576330483,5.0,2.0,46.285121481015516
5467363,1524125526,1524125538,12,222,19.99233953534308,5.0,3.0,55.0
5467364,1524125533,1524125572,39,116,7.2614167741091045,3.0,3.0,50.0
5467365,1524125573,1524125602,29,189,17.328224641963214,5.0,3.0,50.0
5467366,1524125601,1524125609,8,66,48.85783475927399,50.0,20.0,90.17108528571428
5467367,1524125609,1524125622,13,312,2.037924660787165,1.0,1.0,4.0
5467368,1524125619,1524125636,17,351,6.885114015383373,1.0,1.0,50.0
5467369,1524125634,1524125642,8,187,7.656516139871988,4.0,2.313060765,40.0
5467370,1524125641,1524125679,38,221,7.289522330398976,4.0,1.0,50.0
5467371,1524125677,1524125713,36,186,24.209323152233253,7.174517750787471,4.0,60.75918090107737
5467372,1524125711,1524125718,7,192,17.40155659876799,5.374917050691245,1.0,53.32663015324447
5467373,1524125717,1524125732,15,180,17.540893084696084,4.0,2.82393801626462,50.0
5467374,1524125724,1524125733,9,250,4.326156423156445,1.793574712643681,1.0,22.25099499999988
5467375,1524125730,1524125750,20,124,8.250397031287765,2.0,2.0,35.78490033222591
5467376,1524125746,1524125766,20,191,19.453230662418783,5.0,3.0,81.37030936553515
5467377,1524125749,1524125777,28,175,12.665067536965475,3.4945280733944957,3.0,55.0
5467380,1524125767,1524125784,17,8,10.289042277825711,0.0,0.0,50.0
5467381,1524125781,1524125802,21,175,4.644047668789801,2.0,2.0,13.470593092461144
5467382,1524125787,1524125833,46,29,38.269446853255744,49.07166170375885,21.0,55.0
5467383,1524125833,1524125856,23,238,16.235204257191654,5.0,1.0,49.87193059527042
5467384,1524125855,1524125900,45,182,26.805524664435985,20.0,6.0,50.0
5467385,1524125899,1524125909,10,204,19.06759889491584,8.9910277847605,3.0,50.0
5467386,1524125910,1524125924,14,166,9.988906056315658,4.0,3.0,30.49844199095021
5467388,1524125925,1524125940,15,67,4.316299359968547,2.224939241345039,2.0,25.000000000036536
5467389,1524125936,1524125975,39,179,5.593823244900883,3.0,2.0,27.06310597749553
5467390,1524125964,1524125990,26,185,13.909404808563673,5.0,3.514468178101097,50.0
5467391,1524125973,1524125997,24,291,6.375002194922357,1.0,1.0,38.00406553659285
5467392,1524125995,1524126020,25,198,13.718410246147942,5.0,3.0,50.0
5467393,1524126017,1524126054,37,216,13.531168904965517,5.0,2.0,52.55817659837287
5467394,1524126052,1524126084,32,184,36.44468085540859,41.0,5.0,60.0
5467396,1524126084,1524126088,4,134,6.292058301465012,2.0,1.0,20.747977777777717
5467397,1524126087,1524126106,19,270,3.6978757355735117,1.0,1.0,10.873727083112431
5467398,1524126098,1524126133,35,156,5.378257576817823,3.0,2.0,20.0
5467399,1524126125,1524126161,36,99,20.708563502700372,4.96896808580858,2.1,59.04389547758475
5467401,1524126147,1524126174,27,131,12.112155365569299,6.0,3.0,24.0
5467403,1524126174,1524126195,21,161,52.7038176994483,50.0,50.0,55.0
5467404,1524126180,1524126204,24,121,7.460293322132657,4.0,2.0,25.0
5467406,1524126194,1524126215,21,177,29.047013833185815,17.0,3.0,55.0
5467407,1524126197,1524126226,29,73,2.273858922209237,2.060857323019384,1.0,3.0
5467408,1524126207,1524126227,20,109,18.760271340067415,5.0,3.0,55.0
5467409,1524126220,1524126237,17,0,0,0,0,0
5467410,1524126236,1524126253,17,93,11.795252642737106,5.0,4.9406972057276,50.0
5467411,1524126252,1524126291,39,160,11.349906998273832,5.0,2.0,50.0
5467412,1524126290,1524126302,12,190,50.07468980693789,55.0,15.0,81.96572727272714
5467413,1524126300,1524126331,31,142,7.152254350850422,4.0,2.0,27.595279279278977
5467414,1524126331,1524126341,10,141,27.186326251366257,10.0,4.8,91.0
5467415,1524126341,1524126346,5,112,9.424283301608687,4.0,2.0,57.37043192948089
5467416,1524126344,1524126358,14,150,3.5206516575811144,3.0,2.0,5.191939213483143
5467417,1524126357,1524126389,32,136,10.580184817444811,4.0,2.0,50.0
5467418,1524126369,1524126390,21,149,5.628702771617677,3.0,2.0,14.280007647058818
5467419,1524126372,1524126416,44,95,15.232797713859926,4.0,4.0,55.0
5467420,1524126378,1524126427,49,84,12.489289873982594,2.6908998674838496,2.0,50.0
5467421,1524126423,1524126435,12,202,14.672397384406331,5.0,1.0,50.063199455912354
5467422,1524126431,1524126445,14,154,12.502110783096182,6.0,3.0,50.0
5467423,1524126443,1524126454,11,110,14.54658203122507,4.831688016194332,3.0,50.8347810742252
5467424,1524126453,1524126458,5,76,50.19160246046292,55.0,20.555620175438598,55.0
5467426,1524126462,1524126475,13,19,43.74489981885792,50.0,20.0,64.94517173252275
5467427,1524126464,1524126476,12,219,3.7398097873006875,2.0,1.0,12.878290199999995
5467428,1524126467,1524126526,59,7,67.23213439644786,58.34921485156888,26.8526512345679,112.0
5467429,1524126475,1524126528,53,175,13.294009340111389,5.0,3.0,60.0
5467431,1524126494,1524126541,47,219,3.0410985751039057,2.0,1.0,7.57671210449602
5467432,1524126522,1524126542,20,163,13.064243449708435,7.5499805358955845,2.0,50.0
5467433,1524126535,1524126567,32,168,16.609092023572178,5.0,3.0,52.89991433372139
5467434,1524126550,1524126577,27,184,21.270410375790405,6.0,3.0,55.0
5467435,1524126574,1524126595,21,379,1.1231964483906771,1.0,1.0,1.0
5467436,1524126592,1524126612,20,150,21.814197093748632,8.0,5.0,58.39382610627456
5467437,1524126608,1524126636,28,217,5.745280710220951,4.9381962604170795,1.0,20.973932103321026
5467438,1524126633,1524126641,8,291,10.82457870321667,5.0,1.0,50.0
5467439,1524126640,1524126654,14,147,4.6143334831433425,3.0,2.0,20.268136666666667
5467441,1524126657,1524126675,18,106,4.65263791308058,3.0,2.0,5.938417701149423
5467443,1524126675,1524126711,36,90,4.563264815248294,2.0283151866404716,2.0,16.028487857142835
5467446,1524126745,1524126787,42,208,21.53841269787449,7.8770774764521745,4.0,72.20536418195219
5467449,1524126795,1524126817,22,84,9.56911728324536,4.009081304547542,3.0,36.000476165452575
5467450,1524126800,1524126818,18,117,5.609382481026106,4.0,2.1,10.982604503022944
5467451,1524126810,1524126834,24,119,5.229904782335689,2.0,1.506681846153846,20.0
5467452,1524126825,1524126847,22,257,12.767619257528919,3.965453615768636,2.1,50.008712451662795
5467453,1524126846,1524126852,6,200,11.885846936820235,4.0,2.0,50.0
5467454,1524126852,1524126882,30,73,9.319959664624951,4.0,3.0,50.0
5467455,1524126859,1524126891,32,49,13.553681584579623,4.009762054054054,2.0,46.22872283556072
5467456,1524126867,1524126892,25,279,8.092511842235085,2.0,1.0,20.0
5467457,1524126885,1524126907,22,201,10.724993656004385,5.350022265625,1.0,30.0
5467459,1524126900,1524126908,8,63,8.304005112834226,2.4109745799343045,2.0,51.9
5467462,1524126920,1524126935,15,38,9.379784246328994,3.0,3.0,50.0
5467463,1524126933,1524126974,41,177,5.153486904563315,2.0,2.0,20.0
5467466,1524126987,1524127018,31,71,18.497578217225666,5.369873282131189,4.0,55.0
5467468,1524127010,1524127019,9,108,4.8170510782547264,2.11055591160221,2.0,12.95330612478396
5467469,1524127018,1524127055,37,132,4.946080512714368,2.0,2.0,17.0
5467472,1524127037,1524127057,20,185,4.143777458248345,3.0,2.0,6.045666951275068
5467474,1524127050,1524127058,8,90,3.239161309944416,2.0,2.0,6.038549069126805
5467475,1524127054,1524127161,107,178,8.80007872456909,3.039711614026362,2.0,50.0
5467476,1524127060,1524127187,127,146,3.925159868346468,2.0,2.0,8.43469548148147
5467482,1524127100,1524127219,119,30,5.657649636190177,3.0,3.0,22.98713484162895
5467484,1524127144,1524127220,76,206,8.270911196020812,6.0,2.0,22.26274997059165
5467486,1524127185,1524127222,37,146,24.852022266718635,20.368395161290323,4.0,55.8899078007365
5467487,1524127210,1524127337,127,290,12.52621143578098,3.0,1.0,60.36558528610354
5467491,1524127271,1524127338,67,57,40.963024295855064,50.0,20.0,55.0
5467494,1524127303,1524127340,37,185,23.699067152509258,10.0,10.0,58.54529451479428
5467496,1524127329,1524127342,13,118,9.112199824571814,3.0,2.2,54.2
5467497,1524127334,1524127398,64,23,14.057427435059996,8.55882477728429,5.0,54.1
5467498,1524127360,1524127421,61,182,15.782915346653093,6.0,3.0,54.196575563228656
5467499,1524127371,1524127422,51,214,6.94938911627368,2.889805689320389,2.1,50.0
5467500,1524127414,1524127429,15,187,24.219269466108823,8.085427583328471,4.0,62.01188532110089
5467501,1524127425,1524127431,6,131,9.292161521321484,4.601115819107349,2.1,50.0
5467502,1524127428,1524127458,30,131,2.6325862177575012,3.0,2.0,4.0
5467503,1524127456,1524127491,35,285,8.229472050305985,4.0,1.0,40.0
5467504,1524127468,1524127502,34,115,10.515459059430404,2.9370983932416763,2.0,31.406264404342053
5467505,1524127483,1524127515,32,159,11.575835267782633,3.0,2.0,50.0
5467506,1524127493,1524127516,23,129,9.940648792101186,5.0,1.0,50.0
5467507,1524127501,1524127554,53,140,16.046109419339725,4.0,3.0,55.0
5467508,1524127535,1524127567,32,191,15.900958300003168,5.0,2.0,51.52864226809851
5467509,1524127560,1524127581,21,176,19.21146595594559,6.000000001961649,3.0,54.1
5467510,1524127568,1524127591,23,87,29.016042235887763,20.0,4.0,54.2
5467511,1524127571,1524127598,27,380,1.0864745011086474,1.0,1.0,1.0
5467512,1524127597,1524127622,25,153,14.156571781560782,4.939028296703297,2.2,54.2
5467513,1524127621,1524127635,14,206,15.019660921322956,5.0,2.0,61.0
5467515,1524127639,1524127683,44,164,4.994691612687276,2.2,2.1,15.314147770492589
5467517,1524127669,1524127684,15,192,8.01997621872891,3.0,1.0,50.0
5467518,1524127680,1524127752,72,255,11.398347043848974,2.670662317596567,2.1,54.0
5467519,1524127697,1524127755,58,217,12.962441497847392,4.0,1.0,50.0
5467520,1524127701,1524127812,111,291,4.0707078724926395,1.0,1.0,21.0
5467525,1524127789,1524127813,24,211,4.538235796973062,2.0,1.0,15.646739954075763
5467526,1524127794,1524127916,122,44,3.3997220247346305,3.0,2.0,6.33130655190738
5467529,1524127863,1524127917,54,171,6.37696585818075,3.0,2.0,22.856310204081627
5467533,1524127909,1524127918,9,20,29.598233858692595,17.473466666666667,0.0,97.82149047805657
5467535,1524127938,1524127988,50,128,17.086018459644812,5.0,4.0,56.83830435195742
5467538,1524128004,1524128041,37,158,8.284694392549095,3.0,2.0,20.0
5467541,1524128074,1524128130,56,43,26.24238800126766,20.0,0.0,91.0
5467542,1524128099,1524128149,50,64,4.1167628225520625,3.0,2.0,8.747638537505003
5467543,1524128149,1524128202,53,71,13.434792484438592,3.0,2.0,68.78098607375122
5467544,1524128199,1524128205,6,293,21.20540058596696,20.0,1.0,54.58310930475455
5467545,1524128202,1524128212,10,129,13.026860029758183,10.0,2.0,33.41915941176469
5467546,1524128208,1524128219,11,178,5.67830674753744,3.053189599043456,3.0,16.837591891891865
5467547,1524128214,1524128240,26,167,30.52313461390257,20.0,5.0,54.0
5467548,1524128239,1524128254,15,126,9.586210668983385,5.0,3.0,35.35331785714284
5467549,1524128254,1524128271,17,154,11.328866012243129,3.0,2.0,50.0
5467550,1524128269,1524128307,38,217,15.074928234734985,4.0,2.0,59.80932019827549
5467551,1524128295,1524128371,76,158,10.717787217265418,5.0,2.0,23.0
5467552,1524128309,1524128397,88,211,12.886534750843014,5.0,1.0,53.71414737930485
5467555,1524128348,1524128398,50,376,1.1230621703691865,1.0,1.0,1.0
5467556,1524128370,1524128400,30,195,20.419282780055706,6.052491245455917,3.0,60.0
5467557,1524128387,1524128423,36,106,9.134412428771961,5.0,2.0,50.0
5467558,1524128415,1524128442,27,379,1.1220865704772476,1.0,1.0,1.0
5467559,1524128428,1524128444,16,265,17.335428928450543,5.0,5.0,60.0
5467560,1524128438,1524128451,13,170,29.26446872954846,20.0,5.0,54.0
5467561,1524128450,1524128454,4,89,10.490824452981137,5.7500719512195095,5.0,20.783868549280175
5467562,1524128453,1524128458,5,108,4.614139137173021,4.0,1.0,5.0
5467563,1524128457,1524128481,24,131,7.019597153881751,3.0048896294454117,3.0,50.0
5467564,1524128476,1524128485,9,378,1.2351661182464706,1.0,1.0,1.0
5467565,1524128484,1524128500,16,132,15.73260229988434,6.0,6.0,51.73804914297035
5467566,1524128495,1524128528,33,175,8.412966803777005,5.0,2.0,35.0
5467567,1524128500,1524128548,48,165,4.688564270781133,1.0,1.0,12.12252125804018
5467570,1524128526,1524128550,24,203,11.975391510714863,3.0,2.1,54.0
5467571,1524128530,1524128561,31,331,3.9187395605072486,2.1,2.1,4.93287642177415
5467572,1524128558,1524128566,8,205,17.599344827011453,5.175557024793389,1.0,55.0
5467573,1524128562,1524128578,16,41,21.482537691034985,2.0,1.0,58.16108802047032
5467574,1524128569,1524128579,10,149,5.28406720054126,3.0,2.0,19.34710416666646
5467575,1524128574,1524128593,19,170,9.824250243341224,3.0,1.1,50.0
5467576,1524128587,1524128637,50,215,7.902893721753975,3.0,2.1,49.96370540323036
5467577,1524128633,1524128645,12,201,18.34314216278181,5.958244736842105,3.0,54.0
5467578,1524128641,1524128653,12,217,6.122563010708147,2.1,2.0,50.0
5467579,1524128652,1524128678,26,380,1.1762749445676275,1.0,1.0,1.0
5467580,1524128660,1524128708,48,143,32.27300782391336,30.0,14.548128700489983,54.0
5467581,1524128714,1524128735,21,213,33.37209599991216,25.0,6.712111150822824,54.0
5467582,1524128749,1524128758,9,265,9.947650918143312,5.0,1.0,54.0
5467583,1524128757,1524128770,13,84,53.44972988212653,54.0,40.14778099547512,69.45970810810807
5467584,1524128769,1524128796,27,99,10.867988536545996,7.380971651627268,5.0,20.0
5467585,1524128791,1524128807,16,212,18.34018480025543,5.0,1.0,50.22252249999999
5467586,1524128804,1524128849,45,182,11.886905475007199,5.0,1.0,50.294671165056336
5467588,1524128815,1524128850,35,231,4.488997217048185,3.0,1.0,8.89768443804034
5467589,1524128823,1524128852,29,148,7.445902570882655,3.0,2.0,26.424060563380277
5467591,1524128850,1524128895,45,183,15.727661488327174,5.0,2.250629759120803,54.0
5467592,1524128865,1524128952,87,190,8.719114547684027,2.7974315789473696,2.0,50.0
5467593,1524128895,1524129025,130,161,19.077419424896817,7.46788013901023,3.0,54.0
5467594,1524128900,1524129066,166,231,4.4893421704639636,3.0,1.0,15.557662199999998
5467597,1524128967,1524129068,101,265,5.758193061878321,2.1,2.1,40.59228714778359
5467601,1524128989,1524129069,80,144,4.187578455571514,2.0,1.0,5.62054045180343
5467603,1524129013,1524129071,58,124,12.40507200423235,5.0,1.0,57.213628483311105
5467604,1524129063,1524129072,9,200,13.94434407212145,5.0,1.0,50.9674502603979
5467606,1524129109,1524129274,165,108,19.121014053741025,5.0,4.997130715101108,90.0
5467609,1524129152,1524129275,123,45,9.248506636184793,5.0,4.0,40.52407158671586
5467612,1524129202,1524129276,74,111,14.848986684353289,5.0,3.0,53.6
5467615,1524129251,1524129278,27,137,18.158184546374187,5.0,2.1,54.0
5467617,1524129266,1524129279,13,129,9.974554470649018,5.0,2.0,22.972430327479827
5467618,1524129274,1524129334,60,174,5.376340487722397,3.0,2.0,14.138150806494561
5467619,1524129321,1524129421,100,380,0.9894644424934153,1.0,0.1,1.0
5467622,1524129350,1524129445,95,154,6.037178530806482,2.4,1.0,39.61136054421766
5467626,1524129419,1524129446,27,138,7.403009752394035,5.0,1.0,40.310651635963694
5467627,1524129439,1524129522,83,114,11.450084497558146,5.0,1.0,50.0
5467631,1524129472,1524129524,52,96,5.163544730229378,3.0,2.0,5.371155146114244
5467633,1524129482,1524129525,43,166,3.7904938987214623,2.082417742498495,2.0,5.0
5467636,1524129519,1524129734,215,83,51.22562721602874,50.0,40.7779133149873,53.2
5467639,1524129592,1524129736,144,142,25.17185585132002,16.223086337259517,5.0,53.1
5467643,1524129645,1524129737,92,104,7.622145148062846,4.025036291122291,2.1,40.429736389708665
5467646,1524129707,1524129738,31,112,9.430170358559016,5.0,3.0,37.89737137019203
5467647,1524129724,1524129739,15,121,6.571585042246308,3.0,2.0,50.0
5467648,1524129730,1524130035,305,126,7.506884988764742,3.0,1.0,50.0
5467650,1524129754,1524130036,282,379,1.0543840177580466,1.0,1.0,1.0
5467654,1524129786,1524130038,252,204,15.359075910728189,5.0,2.0,53.1
5467657,1524129858,1524130039,181,225,14.498488502258041,5.112000325636908,1.0,50.0
5467661,1524129929,1524130041,112,228,5.917095972361083,3.0,2.1,42.72450332091124
5467665,1524129973,1524130042,69,176,10.359753829167216,3.0,2.0,50.0
5467667,1524130016,1524130044,28,195,11.172411443908944,2.0,2.0,50.0
5467670,1524130045,1524130432,387,164,3.556304106023684,3.0,2.0,5.0
5467674,1524130135,1524130433,298,189,38.347651463423965,50.0,5.0,53.1
5467677,1524130151,1524130435,284,144,15.404417349140925,5.5873030560271655,2.1,46.10579767476743
5467682,1524130202,1524130436,234,198,13.711733593343531,3.0357570256155184,2.0,85.87110639572981
5467688,1524130265,1524130437,172,11,23.89463026619515,20.12522175007869,20.0,53.1
5467691,1524130346,1524130438,92,214,33.671231063530435,40.0,5.0,60.72403259115408
5467694,1524130407,1524130440,33,42,20.127495913159883,19.155146005306605,4.0,50.0
5467696,1524130441,1524130881,440,248,8.03399994576369,3.0,1.0,50.0
5467701,1524130500,1524130883,383,178,11.23264824993606,4.0,2.0,50.0
5467706,1524130576,1524130884,308,4,66.75528700906344,50.64021164021164,26.6005291005291,100.0
5467709,1524130604,1524130885,281,231,9.52339921145309,3.0,1.0,50.0
5467714,1524130716,1524130887,171,189,33.168661985825445,50.0,3.0,53.1
5467718,1524130762,1524130888,126,123,7.053179047608942,5.0,1.9268688,43.61740618556695
5467722,1524130799,1524130889,90,78,6.687231365640737,3.0,1.5,20.9878331902991
5467724,1524130828,1524130890,62,247,9.772225717722128,2.0,1.0,50.0
5467725,1524130877,1524130892,15,166,21.348473916912532,5.09146480301311,3.0,60.0
5467729,1524130919,1524131347,428,179,21.598979462998813,7.895027831540713,3.0,53.6
5467732,1524130939,1524131349,410,161,4.251172884491723,3.0,2.0,8.98893783952197
5467737,1524131013,1524131350,337,198,12.511464913873096,4.025564613076243,3.0,50.978868823529396
5467741,1524131066,1524131352,286,380,1.1260114165373531,1.0,1.0,1.0
5467747,1524131145,1524131353,208,181,15.057471035447762,5.0,2.1,52.50351671896886
5467750,1524131218,1524131355,137,181,24.952834457360243,11.265112294341629,3.1689086823529413,58.77836181768402
5467756,1524131268,1524131356,88,219,12.53976405695976,3.0,3.0,54.0
5467762,1524131323,1524131357,34,222,8.889549651933272,4.0,1.0,50.513764944649445
5467764,1524131340,1524131359,19,129,4.067616192321891,3.0,2.0,6.174882265792447
5467766,1524131349,1524131360,11,189,4.600207450220299,3.0,2.0,10.0
5467768,1524131382,1524131852,470,135,12.775063528869593,5.0,3.0,50.0
5467774,1524131473,1524131853,380,110,9.425679744486224,3.0,3.0,50.0
5467777,1524131533,1524131854,321,379,1.244547956807114,1.0,1.0,1.0
5467782,1524131565,1524131856,291,203,4.970140052361837,3.0,2.1,12.0
5467787,1524131609,1524131857,248,248,9.401259315267803,3.0,1.0,54.0
5467794,1524131689,1524131859,170,204,6.437061896214919,3.0,2.1,32.89233689839566
5467795,1524131711,1524131860,149,379,1.0543840177580466,1.0,1.0,1.0
5467799,1524131825,1524131862,37,131,19.989320350932786,5.883337524557957,4.0,54.0
5467801,1524131837,1524131863,26,73,7.6624299879543365,4.9389355760575775,2.0,24.1341459884044
5467802,1524131839,1524132249,410,380,1.0210321016288018,1.0,1.0,1.0
5467805,1524131890,1524132251,361,157,14.016097527729526,3.503223195757436,3.0,49.68841090795055
5467812,1524131960,1524132252,292,6,7.728706624605678,0.0,0.0,69.08108108108108
5467813,1524132031,1524132253,222,380,1.4435062648865593,1.0,1.0,1.0
5467818,1524132127,1524132255,128,379,1.1120976692563818,1.0,1.0,1.0
5467821,1524132154,1524132257,103,98,14.631542689000534,13.0,9.0,40.0
5467823,1524132196,1524132258,62,169,33.64629379556132,21.0,12.0,54.0
5467824,1524132204,1524132308,104,366,2.5686491949594976,1.0,1.0,7.301048932884108
5467825,1524132264,1524132312,48,154,19.164634770770174,8.0,5.0,58.296587589814685
5467828,1524132293,1524132337,44,76,11.24362294908227,5.0,3.0,22.513052539155197
5467829,1524132332,1524132366,34,207,37.432884580579035,6.347545518867925,3.0,140.0
5467830,1524132348,1524132373,25,132,20.586732947384295,12.0,12.0,54.0
5467831,1524132364,1524132387,23,112,17.998902384378265,12.0,9.0,50.0
5467832,1524132371,1524132388,17,215,3.8920772440892986,4.0,1.0,5.222469541015619
5467833,1524132376,1524132396,20,143,6.76364859830116,3.0,3.0,21.254468086723644
5467834,1524132393,1524132412,19,159,4.889793842975298,3.0,2.6946941211209148,10.748310829932272
5467835,1524132403,1524132434,31,89,8.907570580325702,6.0,6.0,41.0
5467836,1524132422,1524132442,20,117,10.047072798481699,5.0,5.0,50.0
5467837,1524132436,1524132487,51,23,19.190635133615604,21.0,0.0,42.564346317270775
5467838,1524132486,1524132533,47,216,13.284986358448066,5.0,5.0,50.0
5467839,1524132531,1524132548,17,380,1.1189178908493613,1.0,1.0,1.0
5467840,1524132545,1524132560,15,376,1.1328774100084367,1.0,1.0,1.0
5467841,1524132559,1524132569,10,207,47.77195822184283,50.0,18.497763529411767,54.0
5467842,1524132568,1524132583,15,254,10.64330321588172,5.0,4.90625,33.48973393718784
5467843,1524132583,1524132587,4,30,47.33296170812841,50.0,20.0,90.47684462809917
5467844,1524132586,1524132599,13,175,3.981045243551023,4.0,3.01,4.9664390679696595
5467845,1524132598,1524132660,62,137,9.14729962507272,5.0,3.01,40.418256167886874
5467846,1524132660,1524132669,9,235,16.98637321241311,5.0,1.0,71.51416655611564
5467847,1524132668,1524132703,35,185,7.8518749695600345,4.0,3.0,50.0
5467848,1524132702,1524132736,34,362,5.266912378781963,1.0,1.0,41.0
5467849,1524132724,1524132743,19,129,39.23307722736206,5.0,3.01,140.0
5467850,1524132739,1524132748,9,187,7.109044640183215,3.1387395671981775,1.0,49.742586967277084
5467851,1524132745,1524132766,21,179,11.042443278345777,4.0,3.0,54.0
5467852,1524132765,1524132795,30,203,11.635663277179143,4.0,3.0,54.0
5467853,1524132778,1524132818,40,147,6.351862609643861,3.5855947597254003,3.01,16.101662730627265
5467854,1524132792,1524132833,41,306,5.767922083362125,4.0,3.1,5.0
5467856,1524132819,1524132834,15,315,5.119388771758698,4.0,3.1,5.0
5467857,1524132826,1524132866,40,271,3.754741116238506,3.0,3.0,6.048753719008254
5467858,1524132871,1524132888,17,169,19.451800421750463,7.543605753327157,3.612,60.0
5467859,1524132876,1524132904,28,52,14.95337795127513,6.5581308549466755,3.0,84.84976959999997
5467860,1524132903,1524132932,29,127,11.23741976153982,5.5,3.01,50.0
5467861,1524132931,1524132935,4,140,10.665610492601301,3.01,3.0,52.051928802497144
5467862,1524132934,1524132953,19,58,11.666657576132678,4.0,3.6970527736867944,50.0
5467863,1524132952,1524132984,32,204,23.857364892065974,21.41295035564208,3.0,50.0
5467864,1524132971,1524133003,32,180,6.726009283073335,3.0,3.0,47.53705450868034
5467865,1524132987,1524133021,34,135,5.458980269533602,3.0,2.395952685946502,13.427935294117633
5467866,1524133019,1524133052,33,178,14.582332121300462,5.0,3.0,52.501751752577285
5467867,1524133041,1524133069,28,184,20.554031674689746,6.000000000883068,4.0251136290322584,60.0
5467868,1524133060,1524133079,19,301,11.020278764335307,4.0,3.1,50.0
5467869,1524133078,1524133137,59,194,9.333769502964083,3.1,1.5,27.190346511627137
5467870,1524133137,1524133147,10,160,42.997184816371615,15.0625,1.0,140.0
5467871,1524133147,1524133158,11,132,6.089776243848434,3.0000000007646412,3.0,16.94423948782873
5467872,1524133157,1524133195,38,230,18.958541471486047,3.1,3.0,54.0
5467873,1524133193,1524133204,11,176,13.943264857669929,5.0,3.0,51.18414825925924
5467874,1524133204,1524133224,20,121,23.56663214829525,8.721548239714267,1.0,54.0
5467875,1524133223,1524133229,6,142,36.9954551572566,51.261773235294115,3.8502432472324726,54.0
5467876,1524133227,1524133249,22,354,1.3931806199869616,1.0,1.0,3.0
5467877,1524133249,1524133274,25,244,9.641110018587707,5.0,1.0,49.64303013355206
5467878,1524133273,1524133279,6,107,14.56259396571995,9.38149960690213,3.0,41.14111154839919
5467879,1524133279,1524133290,11,97,5.05590737974371,3.0,2.5728321397569447,11.039131867283897
5467880,1524133288,1524133301,13,27,59.94383696854659,51.9,46.83722083333333,109.17127828571428
5467881,1524133296,1524133320,24,332,8.308201374843158,3.1,3.1,50.0
5467882,1524133318,1524133359,41,104,6.634574647196085,3.000000000402042,2.01,25.505785304062318
5467883,1524133357,1524133379,22,205,15.91904592225692,6.0,2.164061961538462,51.9
5467884,1524133380,1524133388,8,332,7.110272946559367,3.1,3.1,39.01310102963414
5467885,1524133384,1524133395,11,169,29.229991869149536,20.0,1.0,91.0
5467886,1524133388,1524133398,10,11,9.254127397896221,5.0,4.26572627892882,43.407983816776785
5467887,1524133393,1524133400,7,360,4.450285043972952,3.1,3.1,5.8319857999999964
5467888,1524133397,1524133407,10,229,3.9592338277834385,3.0,3.0,4.899702214035353
5467889,1524133404,1524133417,13,360,5.574150059886013,3.1,3.1,20.654419840654416
5467890,1524133416,1524133428,12,131,5.954266960666671,3.0,1.0,31.8
5467891,1524133424,1524133443,19,128,4.693518014196377,3.0,2.01,9.867745028695236
5467892,1524133433,1524133445,12,151,11.750749592779986,5.0,2.01,47.12246749790715
5467893,1524133446,1524133478,32,150,7.081862305045161,3.01,2.01,32.74658606896546
5467894,1524133458,1524133486,28,318,10.056782265319374,3.1,3.1,54.0
5467895,1524133486,1524133504,18,177,12.458577725000355,5.0,2.01,47.42064271186438
5467896,1524133502,1524133517,15,308,17.277910629151233,3.1,3.1,54.01
5467897,1524133517,1524133521,4,132,4.06675129250424,3.0,1.0,5.706833359999998
5467898,1524133522,1524133538,16,373,4.277532608683025,3.1,3.1,5.0
5467899,1524133531,1524133546,15,194,4.53272690065575,3.0,1.0,7.5835553254362535
5467900,1524133545,1524133596,51,190,5.318987816086742,3.0,2.0,10.704361910080971
5467901,1524133565,1524133697,132,119,22.990662052297285,5.0,3.0,44.84967870094888
5467904,1524133619,1524133710,91,26,18.54840952731942,16.321331735744135,4.0,46.78290443224313
5467906,1524133654,1524133711,57,192,5.6395311116186155,3.1,2.1,23.202232868565375
5467908,1524133684,1524133724,40,272,19.97642625571237,4.0,3.1,54.1
5467911,1524133713,1524133726,13,293,8.85124264188383,3.1,3.1,63.172966251881725
5467912,1524133718,1524133802,84,65,5.72277208899574,3.0,2.01,27.922924624999947
5467914,1524133743,1524133804,61,162,7.715045949150691,3.1,2.0,49.216800334789276
5467918,1524133786,1524133805,19,305,3.908152713765823,3.1,3.1,6.0
5467919,1524133794,1524133908,114,148,3.841505698914081,2.0,2.0,20.389471559303782
5467921,1524133815,1524133909,94,139,3.723551178146293,3.0,2.01,5.0
5467924,1524133855,1524133910,55,276,2.3863171714312754,1.5,1.5,3.4406569047619007
5467926,1524133880,1524133912,32,319,8.480151242483831,1.0,1.0,50.0
5467928,1524133896,1524133913,17,111,15.926660323383553,6.0,4.0,54.1
5467929,1524133904,1524133971,67,144,5.121132476830619,3.0,2.01,16.704178597785944
5467934,1524133948,1524133972,24,11,55.02169044790264,54.1,40.0,104.66709145299144
5467936,1524133957,1524133973,16,190,5.197981582934015,3.0,3.0,18.097950957318208
5467938,1524133982,1524133998,16,173,8.963849632512778,4.0375163808243055,1.5,52.52724923076921
5467939,1524133986,1524134019,33,164,6.888047842908807,3.0,3.0,37.14415569773663
5467942,1524134031,1524134041,10,130,7.0343677347692655,3.0,2.01,43.328657894736686
5467943,1524134036,1524134062,26,165,23.188370265552418,5.0,4.0,50.0
5467944,1524134051,1524134065,14,162,11.129336018841618,3.1,2.01,48.13358079047493
5467945,1524134061,1524134112,51,140,4.238946561255792,3.0,2.01,5.0
5467946,1524134100,1524134131,31,221,15.302427290240002,10.0,2.0,50.0
5467949,1524134139,1524134152,13,171,7.733394963241563,4.0,4.0,30.0
5467950,1524134144,1524134167,23,318,4.739365159897353,3.1,3.1,5.628485431034481
5467951,1524134152,1524134171,19,348,4.18810585709302,3.1,3.1,8.958867558693425
5467952,1524134166,1524134178,12,152,8.040499441235829,3.0,2.01,38.13189404510478
5467953,1524134175,1524134211,36,128,4.86599548609573,3.0,2.01,12.618731987536234
5467954,1524134205,1524134219,14,124,12.575905210887585,6.0,5.0,55.0
5467955,1524134216,1524134224,8,6,8.093377483443708,0.0,0.0,111.1
5467956,1524134224,1524134247,23,196,5.827887301872107,4.0,1.5,13.36062882891272
5467957,1524134246,1524134259,13,107,9.611423448509916,5.0,5.0,41.0
5467958,1524134255,1524134262,7,163,4.141222353752019,3.1,2.01,5.0
5467959,1524134261,1524134274,13,201,4.47885254278479,3.0,1.0,5.0
5467960,1524134268,1524134287,19,117,5.116768308711134,3.0,3.0,9.79820646499548
5467961,1524134285,1524134295,10,170,9.149325077504473,4.000000001,2.01,42.05212133134496
5467962,1524134290,1524134312,22,150,7.456858543661814,5.0,3.1,50.0
5467963,1524134306,1524134322,16,127,9.982436234902988,5.0,3.1,20.0
5467965,1524134317,1524134327,10,3,43.984375,43.859649122807014,20.0,50.0
5467966,1524134324,1524134364,40,11,6.207515657664778,5.0,4.919766949152542,17.24617647058822
5467967,1524134364,1524134408,44,252,9.4083487687207,5.0,1.0,50.0
5467968,1524134407,1524134431,24,203,15.25576334121286,5.0,1.0,58.00059611758855
5467969,1524134430,1524134467,37,194,14.161061196512966,5.0,3.1,55.0
5467970,1524134465,1524134476,11,204,11.553617843433903,5.0,3.1,50.0
5467971,1524134474,1524134484,10,116,5.895873382487027,3.1,2.01,20.366182059594262
5467972,1524134481,1524134520,39,182,8.560782247592932,3.0,1.0,50.655385999999986
5467973,1524134520,1524134535,15,230,9.493199091865083,4.294907904,1.5,50.0
5467974,1524134532,1524134540,8,143,28.37583445861602,3.1,2.01,140.0
5467975,1524134540,1524134574,34,317,8.63303540202556,3.1,3.1,55.0
5467976,1524134574,1524134594,20,167,10.393110074847874,4.0,2.0,54.705013124999994
5467977,1524134595,1524134619,24,147,8.423353918913367,4.0,3.0,51.835475910856616
5467978,1524134619,1524134656,37,155,8.818004862052582,3.1,2.0,50.0
5467979,1524134656,1524134679,23,172,20.806996783015745,14.811421847246065,3.0,59.59410656219392
5467980,1524134673,1524134683,10,138,10.829605058524578,3.1,2.0,50.0
5467981,1524134682,1524134703,21,241,7.562385811658469,3.0,1.0,37.933635164834904
5467982,1524134702,1524134725,23,117,10.631139979864848,5.081601921666731,3.0,50.0
5467983,1524134711,1524134729,18,163,10.244372465423108,3.1,3.0,50.0
5467984,1524134728,1524134750,22,258,12.370411785889965,3.1,3.1,50.0
5467985,1524134750,1524134782,32,243,12.858888996973524,3.1,1.0,50.0
5467986,1524134779,1524134802,23,222,16.46672412510931,5.0,3.1,54.1
5467987,1524134793,1524134813,20,133,4.9196841733581875,3.0,2.01,5.079991943889316
5467988,1524134797,1524134830,33,139,4.206781669755259,3.0,2.01,5.866532638888856
5467989,1524134812,1524134831,19,135,6.956995387807389,3.0,2.01,47.21284656084645
5467990,1524134823,1524134871,48,111,10.934192434813447,3.1,1.0,50.0
5467991,1524134867,1524134887,20,194,16.41559846335235,5.0,3.0,50.58729794224449
5467992,1524134884,1524134910,26,164,6.023403656271958,3.031611191245959,2.0,40.50124059040589
5467993,1524134908,1524134937,29,178,17.110293495541065,5.0,4.0,54.25068677633437
5467994,1524134922,1524134940,18,176,10.888669003906424,4.260618927428316,1.0,35.5389023647281
5467995,1524134931,1524134946,15,118,4.921612039159664,3.0,3.0,5.50355785764641
5467996,1524134943,1524134957,14,242,15.291456873564837,4.949860381355933,3.0,50.0
5467997,1524134956,1524134962,6,150,7.322512154288464,3.1,2.01,22.295820573941214
5467998,1524134960,1524134967,7,145,5.30847014958822,3.0,2.01,19.10221120234125
5467999,1524134966,1524134974,8,287,7.518389545879276,3.1,3.1,50.0
5468000,1524134972,1524134983,11,12,2.189824503944567,2.1893310405119006,2.000601891839819,2.2
5468001,1524134978,1524134991,13,147,16.793494811687697,5.0,1.5,54.1
5468002,1524134990,1524135012,22,153,4.641609768789702,3.0,2.01,15.465729818181785
5468003,1524135010,1524135027,17,173,25.501985132473624,4.0,2.01,140.0
5468004,1524135025,1524135030,5,165,9.636042579022567,4.0,2.0,50.0
5468005,1524135028,1524135069,41,163,55.26108644897795,54.1,54.1,54.1
5468006,1524135037,1524135070,33,141,11.312081084102008,5.0,1.0,50.0
5468007,1524135047,1524135078,31,110,4.279255699178203,3.0,2.01,6.691432135286825
5468008,1524135059,1524135089,30,214,8.764005066239067,3.0,1.0,50.0
5468009,1524135073,1524135099,26,166,10.124286265798208,4.0,2.01,47.26949473684202
5468010,1524135095,1524135103,8,161,54.869595427773795,54.1,54.1,54.1
5468011,1524135101,1524135123,22,203,13.998612505488513,5.0,3.0,50.0
5468012,1524135121,1524135129,8,208,15.930748519687805,5.0,1.0,54.1
5468013,1524135126,1524135144,18,116,7.241610849489804,3.0,3.0,50.0
5468014,1524135138,1524135171,33,151,8.337275365025475,3.0034181527093597,2.01,45.33671770334925
5468015,1524135172,1524135196,24,205,18.380703624789138,5.130982334384858,3.0,52.93446130965894
5468016,1524135196,1524135216,20,187,8.200698819213823,3.1,2.01,50.0
5468017,1524135214,1524135222,8,149,6.850774965109878,3.0,2.01,30.0
5468018,1524135219,1524135236,17,153,3.245731866681321,3.0,2.01,4.444199399999999
5468019,1524135234,1524135242,8,198,27.41757421567675,5.0,2.0,100.0
5468020,1524135238,1524135306,68,209,8.577679667822443,4.0,3.0,50.0
5468023,1524135264,1524135336,72,190,5.329770770149265,3.0,3.0,6.248363040604524
5468026,1524135298,1524135337,39,226,19.673184364837216,5.0,3.0,91.0
5468027,1524135307,1524135493,186,136,5.624496826354657,3.0,2.0,18.0
5468031,1524135398,1524135495,97,210,8.488005198580595,3.1,1.5,50.0
5468035,1524135462,1524135496,34,189,18.257936164769603,5.0,3.0,50.07103410396942
5468037,1524135475,1524135498,23,122,23.895960358179153,5.3995996522405365,3.1,91.0
5468038,1524135480,1524135559,79,335,7.142939009745367,3.1,3.1,20.0
5468041,1524135534,1524135616,82,170,14.529063462548846,5.0,2.0,50.0
5468044,1524135549,1524135617,68,142,7.063409312002413,3.0,2.0,50.0
5468046,1524135623,1524135693,70,227,10.813342165940545,5.0,3.0,26.67922544526599
5468047,1524135667,1524135694,27,233,16.806233090189444,5.935282002534853,5.0,50.0
5468048,1524135689,1524135706,17,108,30.624876464781646,20.0,12.072575441147182,55.0
5468049,1524135698,1524135718,20,235,5.6351634279493865,4.0,3.0,15.08522526041927
5468050,1524135708,1524135743,35,134,5.844623279334753,3.0,2.0,20.945792165490353
5468051,1524135740,1524135763,23,235,11.494212310066457,5.0,1.0,50.0
5468052,1524135751,1524135783,32,222,7.028869902090508,3.1,3.0,40.89024421726559
5468053,1524135780,1524135803,23,97,51.07967011091947,50.0,41.0,55.0
5468054,1524135802,1524135832,30,52,20.608476753146675,20.0,20.0,23.1
5468055,1524135831,1524135862,31,194,7.528131596683939,5.0,1.0,20.0
5468056,1524135861,1524135874,13,221,13.09485040573538,5.0,1.0,50.0
5468057,1524135872,1524135956,84,138,3.543410909029095,3.0,2.0,5.0
5468058,1524135954,1524135970,16,194,20.15259697975323,14.814795333528478,4.0,57.76808087726212
5468059,1524135958,1524135986,28,267,7.251094498352392,3.1,1.0,46.89301376006038
5468060,1524135986,1524136001,15,183,25.44744230801618,8.932527578368825,5.0,55.0
5468061,1524136000,1524136038,38,226,5.189403818777008,3.0,2.0,9.137745652173857
5468062,1524136037,1524136066,29,208,13.299037563763667,4.979614754915811,2.0,66.47077567567558
5468063,1524136042,1524136084,42,119,4.418829515504193,3.0,2.0,5.0
5468064,1524136066,1524136121,55,210,12.773732716819449,4.0,3.0,57.876087659157676
5468066,1524136113,1524136150,37,88,7.540209666685854,4.0,4.0,20.0
5468067,1524136119,1524136153,34,167,3.1477681437510197,3.0,2.0,5.0
5468069,1524136154,1524136185,31,11,4.0906600573962955,4.0,4.0,5.0
5468070,1524136164,1524136204,40,194,6.428753582683821,3.1,3.0,22.639522043478227
5468071,1524136204,1524136234,30,232,10.378351408940464,5.0,1.0,41.001977628757565
5468072,1524136231,1524136275,44,239,7.430676601897808,3.1,3.1,50.0
5468076,1524136258,1524136276,18,225,3.619608242458099,3.0,1.0,5.001844984374996
5468077,1524136269,1524136332,63,140,5.086118306951804,3.0,3.0,13.714054357541887
5468079,1524136299,1524136333,34,279,9.89211875840253,3.1,3.1,47.54328023032627
5468080,1524136321,1524136335,14,226,11.73624439765825,3.1,3.0,59.44469686581782
5468081,1524136333,1524136358,25,143,4.542233935278218,3.0,2.0,6.0
5468082,1524136350,1524136401,51,337,6.8831322301460025,3.1,3.1,40.0
5468084,1524136372,1524136403,31,190,9.657194547316422,3.1,3.0,20.556138000462855
5468086,1524136385,1524136404,19,124,5.276714609861814,3.0,2.0,14.392987096774132
5468087,1524136391,1524136405,14,369,3.1386213714388425,3.1,3.1,3.1
5468088,1524136399,1524136451,52,172,6.664949495513512,3.0182346440068653,3.0,16.7516108933169
5468089,1524136404,1524136538,134,198,3.7173068919549426,3.0,2.1038754961832065,6.342998206108097
5468091,1524136434,1524136539,105,310,10.276125971756107,5.0,3.1,40.0
5468095,1524136459,1524136541,82,152,8.206562296025893,3.0,1.0,50.12708035730632
5468099,1524136521,1524136542,21,128,8.300952350184021,5.0,1.0,30.648869724770613
5468100,1524136532,1524136642,110,85,5.361152086227076,4.0,4.0,8.937187168081929
5468103,1524136590,1524136678,88,10,22.364990126491275,20.38589890453834,20.0,35.44608241350642
5468107,1524136621,1524136679,58,163,9.26552763180702,3.0,3.0,54.1
5468108,1524136651,1524136683,32,253,8.774437837446408,5.0,3.1,41.0
5468109,1524136665,1524136684,19,272,6.053533381035975,2.0,1.0,26.534185115885144
5468110,1524136673,1524136722,49,141,7.133166670267715,3.0,2.0,21.98049750514159
5468111,1524136689,1524136757,68,122,10.797749101902554,3.1,3.0,55.0
5468112,1524136694,1524136758,64,148,5.2135955360919315,3.0,1.0,11.62115369999999
5468114,1524136723,1524136827,104,109,11.651112756198039,5.400647771855961,4.0,41.0
5468115,1524136729,1524136828,99,137,4.73546384511908,3.0,3.0,5.309858148619179
5468119,1524136782,1524136829,47,119,6.012165110840882,3.0,3.0,38.39144689655171
5468121,1524136819,1524136830,11,110,2.79678180221142,3.0,1.0,4.0
5468122,1524136825,1524136907,82,130,4.308479971079782,2.0,2.0,5.519400445561722
5468123,1524136842,1524136908,66,217,11.809664422931233,5.0,1.5612762494771846,39.114185550239235
5468125,1524136923,1524136956,33,228,16.363662564062093,6.0,3.0,55.0
5468126,1524136937,1524136996,59,70,23.910928162809814,20.0,5.0,55.0
5468127,1524136951,1524136997,46,223,10.555214622884447,3.9963980527522933,1.0,39.714136795600446
5468128,1524136986,1524137015,29,200,13.282085948936704,5.0,2.0,55.0
5468129,1524137011,1524137036,25,173,7.418112622122595,3.0,2.0,41.0
5468131,1524137049,1524137082,33,226,12.145629522553937,5.0,1.0,50.0
5468132,1524137054,1524137084,30,167,37.06879595211293,50.0,3.0,54.1
5468133,1524137068,1524137102,34,186,10.848303400709463,3.0,3.0,20.980268322295807
5468134,1524137092,1524137116,24,120,11.001691460917167,5.441357075306137,3.0,30.009708896797157
5468136,1524137107,1524137134,27,83,3.431154130572712,3.0,2.0,5.566513846807256
5468137,1524137125,1524137171,46,186,6.83632974204858,3.1,3.0,25.82957321428567
5468138,1524137142,1524137173,31,164,8.020541547213758,4.191958050219103,2.0,41.0
5468139,1524137165,1524137220,55,192,12.870397256577636,4.244571763618642,3.0,54.1
5468141,1524137198,1524137222,24,174,13.75643974443511,3.0,1.0,50.0
5468142,1524137215,1524137272,57,205,11.006762650149902,4.076659054392531,2.0,59.39918789999998
5468144,1524137253,1524137332,79,36,47.03369825228186,50.415091493170756,20.524438,55.0
5468148,1524137312,1524137333,21,112,3.991465813422527,3.0,2.0,4.0
5468149,1524137326,1524137388,62,168,11.839369250827513,5.0,2.0,23.600887999999983
5468152,1524137373,1524137389,16,184,13.337230008387202,4.030139980620063,1.0,54.56539668462416
5468153,1524137382,1524137508,126,57,55.41119358467106,50.0,41.0,107.70137112582778
5468157,1524137432,1524137509,77,114,2.994397108136147,3.0,2.0,4.077044541685859
5468159,1524137469,1524137510,41,209,3.804677532773644,3.0,1.0,5.0
5468163,1524137552,1524137599,47,169,4.340972090620156,4.000000001,3.0,7.726308651685387
5468167,1524137570,1524137601,31,179,6.594241751972909,5.0,3.0,7.040381972931732
5468168,1524137583,1524137602,19,151,7.410572321621814,3.0,2.0,19.034298916822877
5468169,1524137585,1524137665,80,174,17.589764076949535,5.658135127465865,1.5,50.0
5468171,1524137616,1524137721,105,115,12.722093226483347,6.94230752688172,3.0,52.375295033922534
5468175,1524137679,1524137723,44,123,12.81963661813595,6.396725839719351,2.0,50.0
5468176,1524137714,1524137850,136,182,12.136179929975098,4.023115472736688,3.0,50.0
5468180,1524137782,1524137851,69,103,26.731536574103085,9.209185508920735,3.1,55.0
5468183,1524137861,1524137930,69,49,28.40997021861365,20.609375069102526,20.0,55.0
5468185,1524137884,1524137931,47,227,9.735884767678876,4.0,1.0,50.0
5468186,1524137918,1524137932,14,208,18.9937128840422,6.349621544783966,3.0,55.0
5468187,1524137922,1524137959,37,126,5.495346604582527,4.493258314855876,3.0,12.145955445078341
5468188,1524137932,1524137978,46,158,5.839613068055595,3.0,3.0,11.345191114677432
5468189,1524137975,1524137988,13,205,11.062703605185193,4.000000001,3.0,51.44252991215718
5468190,1524137981,1524138022,41,192,4.133279283115058,4.0,4.0,4.0
5468191,1524138021,1524138030,9,209,11.372758746680011,4.000000000522164,1.0,50.0
5468192,1524138025,1524138051,26,116,4.1015737352396595,4.0,3.4092243911111115,4.0
5468193,1524138051,1524138075,24,175,9.446329630330686,3.0,2.0,50.0
5468194,1524138074,1524138100,26,248,11.458919945716227,3.0,1.0,50.0
5468195,1524138088,1524138107,19,92,4.506854903960649,3.0,2.0,5.0
5468196,1524138101,1524138126,25,129,10.46794630547375,5.014199794101179,2.1,50.0
5468197,1524138109,1524138131,22,65,3.563030102418019,3.0,2.0,4.0
5468198,1524138120,1524138149,29,200,6.227023533992109,3.0,1.0,21.0
5468199,1524138146,1524138155,9,154,12.280148063629488,5.0,2.0,42.717655172413735
5468200,1524138153,1524138167,14,192,4.781474618183418,4.0,3.0,4.109017413162702
5468201,1524138161,1524138177,16,145,2.9865208562878736,3.0,1.0,4.009253245682465
5468203,1524138191,1524138210,19,219,8.838266644938042,3.0,2.0,50.0
5468205,1524138218,1524138291,73,195,7.639470892069085,3.0,1.0,50.0
5468210,1524138252,1524138386,134,200,10.49112561625374,3.0,3.0,54.1
5468215,1524138333,1524138387,54,188,7.131175143487546,3.0,1.0,43.78883985148498
5468218,1524138356,1524138389,33,98,9.285844324908025,5.8136442533557044,2.151208309373203,41.0
5468220,1524138386,1524138444,58,159,4.502420787331635,3.0,2.0,12.408649637537495
5468225,1524138456,1524138526,70,129,2.9380432066555056,3.0,2.0,3.366857682926829
5468228,1524138501,1524138527,26,143,16.26859771919682,5.0,3.0,54.1
5468229,1524138525,1524138671,146,60,28.95795911328968,20.0,20.0,54.922251632467656
5468232,1524138564,1524138672,108,189,4.912500790420504,3.0,2.0,20.445160917187913
5468238,1524138632,1524138673,41,86,11.480454824168268,4.915640677966102,3.0,50.0
5468239,1524138648,1524138674,26,142,6.854857459784999,3.0,3.0,41.0
5468240,1524138668,1524138778,110,113,9.498797538851946,3.0,3.0,50.0
5468243,1524138703,1524138791,88,125,7.7201085361086825,3.0,2.0,20.0
5468246,1524138742,1524138792,50,204,7.715077189886397,2.0,2.0,50.02043691637219
5468247,1524138760,1524138793,33,150,11.907064864565559,4.21510251628543,2.0,41.0
5468248,1524138786,1524138996,210,96,3.6503036917210916,3.0,2.0,5.0
5468252,1524138837,1524138997,160,123,13.54704139834014,5.0,2.0,50.0
5468258,1524138892,1524138999,107,159,54.23114486863671,54.1,54.1,54.1
5468262,1524138928,1524139000,72,189,10.052394030714357,3.0,2.0,48.388960222741815
5468264,1524138977,1524139001,24,175,15.949752539908003,3.0,2.0,56.92614446620959
5468265,1524138999,1524139175,176,126,7.413161591653156,3.0,2.048149692307692,41.0
5468267,1524139042,1524139243,201,175,17.735404583705968,5.0,3.0,55.0
5468272,1524139133,1524139244,111,112,15.615574522575553,5.0,3.0,60.0
5468274,1524139225,1524139245,20,202,14.478388148613542,5.837392829106281,5.0,50.0
5468277,1524139265,1524139345,80,111,11.270574382698777,5.0,3.0,50.0
5468278,1524139274,1524139346,72,192,8.005427255169907,4.0,3.0,48.019001219019955
5468279,1524139284,1524139369,85,194,16.48173385877539,3.0,2.0,55.0
5468280,1524139352,1524139371,19,214,20.14761439354633,6.168344047619048,3.0,56.037566841605006
5468281,1524139355,1524139416,61,135,6.479811044339245,4.000000000466187,3.0,20.691561085972843
5468282,1524139409,1524139422,13,188,50.47166049353315,50.0,14.554840332661291,91.0
5468283,1524139417,1524139423,6,177,7.713042610907909,5.0,4.0,12.17602649866666
5468284,1524139418,1524139426,8,134,4.166088423383475,3.0,3.0,4.0
5468285,1524139423,1524139447,24,164,12.521380290757575,4.0,3.0,36.86415742679251
5468286,1524139445,1524139460,15,197,6.811020759395528,4.0,3.0,31.41693216198504
5468287,1524139454,1524139483,29,213,6.663281871571965,3.0,1.0,41.0
5468288,1524139479,1524139495,16,101,21.627524275257407,5.0,3.0,68.51750857142856
5468289,1524139483,1524139497,14,203,9.306271117257399,3.0,3.0,50.0
5468290,1524139492,1524139512,20,199,13.965415716097311,4.0,3.0,66.55987877374945
5468292,1524139515,1524139522,7,210,6.0342055681458575,3.0,3.0,16.250680116404524
5468293,1524139519,1524139523,4,145,5.377117725361132,3.0,3.0,7.831801106546602
5468294,1524139520,1524139550,30,188,12.337888733068072,15.0,2.172714526064425,15.0
5468295,1524139534,1524139558,24,200,10.799844506219381,4.0,2.1,50.0
5468296,1524139564,1524139583,19,235,29.441756450793463,15.0,15.0,54.0
5468297,1524139581,1524139606,25,240,9.78462060393323,4.0,2.01,50.0
5468298,1524139598,1524139618,20,114,11.700428507916387,3.383288615384617,2.7029512568839467,50.0
5468300,1524139619,1524139625,6,146,6.128789673785884,2.988174496958353,2.0,18.731154954954942
5468301,1524139622,1524139668,46,163,5.3256804211921684,2.1524332390381895,2.0,19.897241991073546
5468305,1524139666,1524139707,41,12,3.052688815439556,3.0,3.0,3.0
5468306,1524139679,1524139708,29,137,6.153507729421335,3.0,2.0,39.041674999999984
5468307,1524139691,1524139745,54,221,12.464538543233433,3.0,2.0,50.0
5468308,1524139738,1524139786,48,166,20.682457244949532,4.0,3.0,64.75703859693249
5468311,1524139783,1524139805,22,213,32.20392273944695,20.0,3.0,91.0
5468312,1524139789,1524139838,49,142,3.7788405741849327,3.0,2.0,3.0
5468313,1524139835,1524139855,20,190,18.381888082111505,5.0,2.01,53.896830243626795
5468314,1524139847,1524139873,26,158,54.238939751744155,54.0,54.0,54.0
5468315,1524139871,1524139877,6,223,19.524787086481204,7.008324408223461,1.0,54.0
5468316,1524139876,1524139900,24,136,53.802228480236295,54.0,54.0,54.0
5468317,1524139887,1524139907,20,131,12.89785234908912,5.0,3.0,50.0
5468318,1524139903,1524139920,17,208,14.74415414396065,3.0,3.0,54.0
5468319,1524139918,1524139935,17,224,9.64696724096083,3.0,1.0,50.0
5468320,1524139934,1524139946,12,127,13.503630241000643,5.0,3.0,50.0
5468323,1524139955,1524139965,10,149,6.162713892311802,3.0,2.0,32.440222176425735
5468324,1524139958,1524139994,36,127,4.1370869197062525,2.0,2.0,11.293783255549528
5468326,1524139984,1524140010,26,142,53.720647346881876,54.0,21.0,91.0
5468327,1524140002,1524140027,25,218,14.47917512054783,6.0,2.0,50.0
5468328,1524140025,1524140042,17,207,16.72088033703063,6.83790372705713,3.0,50.0
5468329,1524140035,1524140052,17,190,16.081384153287583,3.0,3.0,54.0
5468330,1524140043,1524140059,16,152,10.210544466899034,3.0,2.2,50.0
5468331,1524140054,1524140100,46,167,17.59232164787929,5.0,1.0,54.0
5468332,1524140101,1524140114,13,207,21.003428695022706,6.0,3.0,50.0
5468333,1524140113,1524140124,11,143,16.071216624520556,3.609092382812499,3.0,54.0
5468334,1524140123,1524140150,27,120,6.378457083140935,3.0,2.0,36.08030442804419
5468335,1524140148,1524140166,18,233,19.125797987460412,4.000000000296832,1.0,54.0
5468336,1524140166,1524140185,19,139,19.465095500691497,5.0,3.0,54.89388471780242
5468337,1524140185,1524140197,12,208,16.58323293462411,5.515127753723176,1.0,50.149540146987796
5468338,1524140197,1524140243,46,192,32.13859094820116,41.61324548607633,3.0,55.0
5468339,1524140242,1524140256,14,183,20.72681951597714,20.0,3.0,50.0
5468340,1524140256,1524140276,20,138,6.2002339998221885,3.0,2.0,36.66480336551721
5468341,1524140276,1524140291,15,186,9.988751633992178,3.0,2.0,49.3909317164179
5468342,1524140292,1524140312,20,204,9.33235455204543,3.0,2.0,50.0
5468344,1524140311,1524140347,36,232,15.492139654767687,3.0,1.5,65.0
5468346,1524140351,1524140374,23,143,54.25538974345685,50.0,50.0,91.0
5468347,1524140356,1524140397,41,190,7.7273471587934415,4.000000000770379,2.0,20.0
5468348,1524140374,1524140418,44,226,17.27470523175647,4.817460769409795,2.01,54.77057532832107
5468351,1524140400,1524140419,19,111,21.06421647218967,5.0,3.0,55.0
5468353,1524140448,1524140457,9,140,22.81643068513932,18.80861100917431,3.42815990877193,52.88538250437073
5468354,1524140453,1524140477,24,166,5.214012363948143,3.0,2.0,18.48038367346938
5468355,1524140459,1524140536,77,381,66.06906686260103,65.0,65.0,65.0
5468356,1524140494,1524140558,64,377,89.46765103697024,65.0,65.0,125.69889298892977
5468357,1524140556,1524140604,48,169,34.52733809385382,40.0,1.0,54.0
5468358,1524140604,1524140609,5,170,11.072702682705764,5.0,3.0,50.0
5468359,1524140607,1524140617,10,149,22.500736904458652,9.552813386301011,3.0,65.0
5468360,1524140616,1524140637,21,131,5.338683842839399,3.0,3.0,12.719572026888962
5468361,1524140636,1524140649,13,379,67.99890296306481,65.0,65.0,101.49439085714279
5468362,1524140645,1524140651,6,243,57.12799423904309,54.0,54.0,65.0
5468363,1524140648,1524140663,15,149,23.306054303559804,20.0,4.0,54.0
5468364,1524140661,1524140680,19,111,8.702194580421693,5.0,3.0,43.71274432812134
5468365,1524140678,1524140688,10,147,12.266536095165561,3.0,3.0,91.0
5468366,1524140689,1524140739,50,175,7.3400709032628075,3.0,2.9157709164826997,44.57701934310461
5468367,1524140738,1524140745,7,194,17.651895285297748,5.0,3.0,65.0
5468368,1524140744,1524140759,15,295,1.5105937623591148,1.0,1.0,2.0
5468369,1524140767,1524140797,30,155,12.453960727091504,3.0,2.0,49.37678982343586
5468370,1524140796,1524140814,18,182,24.189405854717805,20.0,4.207409883636363,55.0
5468371,1524140805,1524140815,10,100,5.383919113030167,4.2101054283917145,2.789334260090789,10.041118927272228
5468372,1524140810,1524140874,64,151,4.895484712484975,5.0,1.0,18.190173684210496
5468373,1524140873,1524140880,7,192,13.951053350294837,5.0,3.0,50.0
5468374,1524140879,1524140895,16,75,10.146242213746365,4.481473113726074,2.01,35.73890357142849
5468375,1524140895,1524140907,12,113,13.47398613949352,6.406139009524696,3.0217398131235074,48.03008421052629
5468376,1524140906,1524140925,19,99,7.379696111726516,3.0,2.0000000644066267,42.908932653061115
5468377,1524140925,1524140965,40,243,17.469969243427894,5.0,3.0,55.0
5468378,1524140963,1524140972,9,223,25.318603484137256,20.0,1.0,59.41139764936336
5468379,1524140973,1524140987,14,154,6.008426180849062,3.0,1.0,20.19757802619622
5468381,1524140993,1524140997,4,17,44.29465952994955,50.0,20.0,55.0
5468382,1524140996,1524141009,13,181,7.537291702774698,3.0,2.01,31.809462729458648
5468383,1524141008,1524141023,15,64,51.94674217807466,55.0,42.30569107406886,55.0
5468384,1524141021,1524141029,8,195,7.48531405612284,5.0,3.0,23.479877304964536
5468385,1524141027,1524141054,27,202,9.529513551893505,4.0,2.0,55.0
5468386,1524141053,1524141082,29,202,6.882625724570844,3.0068502076155132,2.0,36.744383529411735
5468388,1524141093,1524141109,16,98,9.806246543702416,3.0,3.0,50.1
5468389,1524141099,1524141110,11,221,22.0626648846331,2.0,1.0,32.31283372058875
5468390,1524141106,1524141129,23,119,7.264842391488496,3.0,2.0,20.0
5468391,1524141116,1524141131,15,103,23.134537705683346,10.0,1.0,55.0
5468392,1524141128,1524141161,33,155,6.912593505156404,3.0,2.0,23.544801476014733
5468393,1524141160,1524141180,20,195,35.458819541782226,30.0,5.0,76.69724191968658
5468394,1524141170,1524141203,33,182,14.869339469224858,5.0,1.0,50.1
5468396,1524141184,1524141205,21,133,4.891159507777604,3.0,2.0,20.0
5468397,1524141197,1524141232,35,122,5.309085226789051,3.0,2.0,21.75689155567709
5468398,1524141205,1524141245,40,159,10.915682520630636,3.0,2.0,41.0
5468399,1524141245,1524141260,15,177,23.692775491894306,18.0,1.0,55.0
5468400,1524141256,1524141262,6,178,11.962729029042306,5.0,4.0,50.1
5468401,1524141259,1524141272,13,207,5.068331189237624,4.0,3.0,4.4
5468402,1524141271,1524141276,5,153,11.11613392102488,2.0,2.0,52.356399088735635
5468403,1524141274,1524141298,24,204,6.392916547605393,2.0,2.0,40.99523543338156
5468404,1524141278,1524141300,22,151,4.553456216786868,3.0,2.0,7.904737931033907
5468405,1524141294,1524141344,50,81,20.780334492319614,10.0,1.0,59.58852346168661
5468406,1524141315,1524141347,32,129,9.324770736425036,4.4034380897497085,2.0,41.0
5468408,1524141335,1524141360,25,143,9.832363253168236,3.0,2.2,50.0
5468409,1524141347,1524141367,20,150,7.991047923309147,2.7874298895705523,2.0,50.0
5468410,1524141366,1524141375,9,186,10.335951944520742,3.0,2.0,41.0
5468411,1524141371,1524141416,45,112,7.484250908230795,2.0,2.0,45.74070435285909
5468412,1524141416,1524141433,17,158,37.65538403283695,20.0,5.0,99.99999860247168
5468414,1524141426,1524141439,13,32,42.455713526985804,50.0,20.0,55.0
5468415,1524141436,1524141485,49,189,6.768596700635859,3.0115727692307694,2.0,50.0
5468416,1524141484,1524141515,31,264,16.5302751745218,20.0,1.0,50.0
5468417,1524141504,1524141518,14,106,14.494233548092536,8.0,4.0,50.35194115611283
5468418,1524141519,1524141559,40,99,51.06219445546275,55.0,20.0,55.0
5468419,1524141559,1524141576,17,100,18.058960056504823,8.0,4.07374053019116,54.604370231881944
5468420,1524141576,1524141584,8,157,11.050389867525096,4.0,2.5625,50.38208655683175
5468421,1524141582,1524141594,12,40,57.39201823017687,55.0,50.0,112.0
5468422,1524141593,1524141598,5,163,12.927032463048704,5.0,3.0,55.0
5468423,1524141596,1524141599,3,147,5.769687590941009,3.0,2.2,40.36945823529408
5468424,1524141599,1524141634,35,129,3.7422084175728103,1.0,1.0,32.07895367412129
5468425,1524141632,1524141649,17,95,25.692471736480005,20.0,5.0,60.94682139253277
5468426,1524141648,1524141667,19,26,49.129398072922754,50.094260731760976,24.0,70.38330599874904
5468427,1524141668,1524141673,5,184,11.34693600577877,4.07925300020747,2.1,50.0
5468428,1524141673,1524141715,42,79,22.87835369775737,7.576467026279244,5.0,51.40394230173958
5468429,1524141714,1524141771,57,128,12.720603129978416,5.0,4.0,50.1
5468430,1524141769,1524141800,31,108,40.996009002026014,30.0,3.4510930434782634,112.0
5468431,1524141801,1524141809,8,251,10.39233499122439,1.0,1.0,50.308329048378006
5468432,1524141807,1524141851,44,138,7.614356090718944,4.0,3.0878721842105263,50.0
5468433,1524141851,1524141880,29,179,17.228769076673675,4.000000000751552,3.0,60.58291973913043
5468434,1524141879,1524141886,7,172,27.143953922274488,18.0,1.0,91.0
5468435,1524141885,1524141903,18,75,31.248254090857028,20.0,5.0,55.0
5468436,1524141903,1524141914,11,213,11.365406494848637,4.0,3.0,41.0
5468437,1524141913,1524141947,34,120,38.52058123387259,55.0,4.0,55.0
5468438,1524141946,1524141970,24,59,41.35264755461881,41.3058052472455,20.0,100.0
5468439,1524141970,1524142003,33,187,7.780252133740575,4.4,4.0,26.177099999999903
5468440,1524142003,1524142020,17,106,26.61009758590108,15.528076241892803,5.0,90.82146598772161
5468441,1524142020,1524142033,13,139,10.595838474931154,4.0,3.0,50.012362746619765
5468442,1524142031,1524142039,8,106,5.3861329286574415,4.0,2.1,20.0
5468443,1524142039,1524142045,6,34,18.406749194263664,13.07213185483871,5.0,54.42095892857142
5468444,1524142041,1524142063,22,10,21.863662877754148,6.239498825007049,5.0,73.80293548387095
5468445,1524142062,1524142086,24,167,9.713760871829013,4.0,2.0652086611271465,50.0
5468446,1524142085,1524142090,5,196,8.559995345912187,3.0,2.0002,50.02033071755713
5468447,1524142090,1524142095,5,248,6.688839256975204,2.0002,2.0,16.634922758620675
5468448,1524142093,1524142109,16,142,6.9079531752078775,3.0,3.0,50.0
5468449,1524142103,1524142111,8,178,14.259147200368284,5.0,4.0,50.0
5468450,1524142109,1524142128,19,114,9.187395427022874,5.0,5.0,20.9858916
5468451,1524142126,1524142132,6,48,30.139652999869313,19.893898030845875,5.0,100.0
5468452,1524142131,1524142140,9,145,5.542805503754596,3.0,2.0,8.005313739740082
5468453,1524142138,1524142162,24,142,5.65589049917384,3.0,2.0,21.35416665692045
5468454,1524142162,1524142172,10,208,8.40563268173738,4.0,1.0,41.0
5468455,1524142170,1524142182,12,172,6.569257105805211,3.0,2.0,41.88104374999998
5468457,1524142186,1524142204,18,189,6.027608907016599,2.0,2.0,37.227632499999935
5468458,1524142192,1524142244,52,37,38.22965458646984,40.87598198198198,5.0,112.0
5468459,1524142195,1524142245,50,252,3.4245714556379703,2.0,1.78125,9.301731292516983
5468462,1524142231,1524142364,133,123,4.120213706959064,3.0,2.0,29.320822101105573
5468467,1524142319,1524142366,47,33,46.093094154028705,40.15709831662532,20.0,96.91878098222014
5468468,1524142324,1524142367,43,177,3.0007394828477234,3.0,2.0,5.0
5468470,1524142364,1524142417,53,145,13.352157791614298,4.000000001,2.0,50.1
5468472,1524142382,1524142426,44,91,26.967796642371617,15.373281722440726,4.0,55.0
5468475,1524142422,1524142427,5,8,50.16860372443822,50.02064402312622,43.058112354789735,58.37030552036199
5468477,1524142430,1524142442,12,40,4.861215755491496,3.0,3.0,11.140630422110245
5468478,1524142434,1524142486,52,164,2.614237411106119,2.1,2.0,4.0
5468479,1524142487,1524142501,14,153,21.91827993169068,20.0,4.0,60.0
5468480,1524142496,1524142511,15,261,6.3919751839199535,2.1,2.1,50.0
5468481,1524142515,1524142529,14,112,43.71824717512733,55.0,7.433626129032258,70.67953650091653
5468482,1524142528,1524142539,11,268,4.93300572452286,2.1,2.007909897064233,22.07202857142852
5468483,1524142537,1524142543,6,134,29.93800808331726,20.371559005833735,2.0,55.0
5468484,1524142540,1524142570,30,88,3.2517830825959395,2.0,2.0,4.979952110207292
5468485,1524142562,1524142583,21,208,14.146375963742331,4.0000000001344524,2.0,55.0
5468486,1524142580,1524142602,22,247,6.968662075820923,2.0,1.0,50.0
5468487,1524142601,1524142636,35,113,51.466047050567866,55.0,27.551549815498156,55.0
5468488,1524142635,1524142660,25,176,11.381035886804911,5.0,2.0,46.13133876063078
5468489,1524142657,1524142662,5,119,49.78082508646404,55.0,10.963112258064516,57.15516080810551
5468490,1524142660,1524142665,5,111,5.494379473068062,3.0,2.0,14.979100003991896
5468491,1524142663,1524142676,13,173,6.675624565378915,3.0,2.0,50.0
5468492,1524142666,1524142706,40,234,20.672851434099748,5.0,1.0,55.0
5468493,1524142686,1524142707,21,68,54.545995907042915,55.0,55.0,55.0
5468494,1524142688,1524142711,23,202,7.678156914420086,4.0,2.0,40.7527512
5468496,1524142713,1524142742,29,156,9.179550648917331,4.0,2.0,51.15090293862188
5468497,1524142727,1524142765,38,84,6.701183447585733,3.0,2.0,41.0
5468498,1524142756,1524142783,27,144,13.356143689872528,5.0,3.0,50.057148596443525
5468499,1524142779,1524142797,18,126,29.383230367051308,20.0,1.0,55.000000001
5468500,1524142798,1524142808,10,176,11.525025385661584,4.087414222222222,2.0,41.0
5468501,1524142808,1524142822,14,130,8.845111584626506,4.0,2.0,50.0
5468502,1524142815,1524142833,18,107,34.090022015547845,47.39311577744989,1.0,55.000000001
5468503,1524142820,1524142856,36,208,6.517782692752765,3.0,2.0,40.34747199999999
5468504,1524142854,1524142871,17,128,50.87640007512958,55.0,20.0,61.91132763051893
5468505,1524142870,1524142890,20,256,14.841271508035346,10.0,1.0,40.878633101851825
5468506,1524142889,1524142906,17,62,29.401279042131225,26.346170385993855,2.0,54.744278674220546
5468507,1524142903,1524142915,12,202,7.865868237161271,5.0,3.0,33.579624675544196
5468508,1524142914,1524142921,7,223,8.452626422450452,3.29419115079563,1.0,49.39441394747709
5468509,1524142919,1524142948,29,96,12.57300657136025,6.617900431014476,2.5625,50.23778202676864
5468510,1524142947,1524142950,3,136,6.926679806116604,4.0,2.0,21.0
5468511,1524142949,1524142967,18,75,6.114083579898926,3.0,2.0,17.551551122152766
5468512,1524142966,1524143019,53,148,8.708182314020657,4.0,2.0,49.3720202564578
5468513,1524143020,1524143034,14,242,22.230951372239765,17.0,1.0,60.0
5468514,1524143029,1524143041,12,58,40.187147485230085,40.0,20.0,55.0
5468515,1524143042,1524143049,7,133,8.920388372340025,5.0,2.0,50.0
5468516,1524143047,1524143062,15,120,5.7071279504685934,3.0,2.0,24.792402499999987
5468517,1524143061,1524143076,15,137,13.056926413252615,5.0,1.0,52.071609758521994
5468518,1524143073,1524143079,6,65,27.236960353127376,8.933474038480107,2.422909574468088,84.59835866028709
5468519,1524143078,1524143124,46,27,14.033266419456233,6.186724595526102,3.5777860606060603,50.0
5468520,1524143122,1524143128,6,180,28.759658754975817,21.0,4.0,60.44897022526934
5468521,1524143126,1524143139,13,163,4.286587559209368,3.0,2.0,4.0
5468522,1524143134,1524143162,28,164,9.280119726214217,3.0,2.0,50.08625167803872
5468523,1524143161,1524143181,20,257,16.33443751747233,4.0,1.0,61.17875390441547
5468524,1524143180,1524143205,25,198,9.80419402174061,4.0,2.0,50.02116688905892
5468525,1524143184,1524143235,51,210,5.938893636238519,3.0,2.0,18.28693714285708
5468526,1524143232,1524143264,32,164,23.143610970277535,15.000000000678154,4.0,55.0
5468527,1524143249,1524143268,19,165,4.867036136450945,4.0,2.147123606142024,7.740813845234033
5468528,1524143267,1524143280,13,217,16.143962989406102,5.0,1.0,55.0
5468529,1524143275,1524143289,14,212,16.035686190421195,5.0,2.0,55.0
5468530,1524143287,1524143299,12,63,8.013135594621271,4.973209685568865,4.0,37.25851179999999
5468532,1524143308,1524143318,10,158,9.841304549139725,3.0000000196944803,2.0,42.07843751717062
5468534,1524143325,1524143352,27,152,5.488008683791796,3.0,2.0,20.23885784915103
5468536,1524143350,1524143381,31,145,8.445811175801504,4.000000001,2.0,31.536776720572103
5468538,1524143367,1524143401,34,144,6.257389194987617,3.0,2.0,30.0
5468541,1524143389,1524143402,13,283,3.852434000257825,2.0,1.5,12.850728938458449
5468546,1524143434,1524143461,27,9,55.006345785440615,35.83894230769231,21.0,112.0
5468550,1524143457,1524143462,5,191,3.881850689071482,2.0,2.0,5.4855777087033735
5468551,1524143460,1524143535,75,220,6.858746266921942,3.0,2.0,41.0
5468554,1524143519,1524143537,18,180,7.109147233000261,3.0,2.0,42.69458793129003
5468556,1524143539,1524143573,34,219,4.960089489191492,2.0,1.0,20.39388467396208
5468557,1524143555,1524143575,20,138,7.192741810073336,3.0,2.0,47.05888549164695
5468559,1524143586,1524143612,26,176,18.205917169522294,5.051390113640927,2.0,60.031422935779815
5468561,1524143617,1524143642,25,127,24.412686078009816,20.0,4.920900692307693,55.0
5468562,1524143624,1524143658,34,162,4.520279958050092,3.0,2.0,6.536363343959898
5468563,1524143645,1524143659,14,153,19.280172053284403,5.0,3.0,55.0
5468565,1524143665,1524143681,16,163,10.17100528901018,3.0,2.0,47.09217310747691
5468567,1524143700,1524143727,27,178,19.89942750455817,5.439450694444445,1.0,63.37939685863864
5468568,1524143719,1524143760,41,207,11.213191823072732,3.0,2.0,59.653226762470005
5468569,1524143758,1524143803,45,150,22.13781146469737,6.243422172497763,1.0,55.0
5468570,1524143789,1524143804,15,210,11.320008814349277,4.000000000187493,2.0,55.621653692976096
5468571,1524143795,1524143825,30,239,8.344019784533643,3.0,1.0,50.000794309180364
5468572,1524143821,1524143849,28,76,15.80595818954046,7.824337535559791,4.0,55.0
5468573,1524143849,1524143858,9,141,16.749012248061362,6.0,1.0,50.445919757212266
5468574,1524143855,1524143866,11,175,46.23865725144826,50.0,20.0,55.0
5468575,1524143865,1524143883,18,134,4.0100530467195865,3.0,3.0,5.47365567570051
5468576,1524143880,1524143887,7,112,7.906139435495254,3.0,2.0,50.0
5468577,1524143884,1524143897,13,296,20.21677909911114,5.0,2.0,50.0
5468578,1524143898,1524143914,16,170,9.794869086795593,3.0,1.0,50.0
5468579,1524143913,1524143955,42,169,10.848306429650897,5.0,2.0,50.09115787719804
5468580,1524143949,1524143973,24,257,36.905933774245575,44.6962142857143,6.0,60.839793111111106
5468581,1524143973,1524143985,12,145,9.912331483572443,5.0,3.0,50.0
5468582,1524143984,1524144016,32,199,11.188195659575957,3.0,2.0,50.0
5468584,1524144018,1524144032,14,133,7.2447909519101605,4.255479327667597,3.0,21.0
5468585,1524144024,1524144046,22,68,3.0669413174866595,3.0,2.0,4.59216842696629
5468586,1524144044,1524144058,14,214,16.253831513169782,6.019594441844632,3.0,54.0
5468587,1524144057,1524144063,6,130,6.776288411593889,3.0,2.0,50.0
5468588,1524144062,1524144095,33,197,5.8171721456423535,2.0,2.0,35.01626145937886
5468589,1524144096,1524144116,20,163,32.206061175535005,30.0,5.0,55.0
5468590,1524144105,1524144128,23,190,9.447462256868988,4.0,2.0,41.0
5468591,1524144126,1524144213,87,162,11.307396769731717,4.004604489795918,2.0,50.09616029850746
5468592,1524144212,1524144276,64,214,27.748890379375528,21.0,4.95702187000842,55.0
5468593,1524144277,1524144299,22,153,34.00133033589072,50.0,5.0,50.340400991638155
5468594,1524144297,1524144325,28,288,19.719869678542338,6.0,1.0,51.64302174883479
5468595,1524144324,1524144351,27,240,50.10960163220894,50.0,17.119575,100.0
5468596,1524144350,1524144354,4,103,19.525321109749022,15.328148571428573,5.0,50.0
5468597,1524144354,1524144364,10,201,7.6566603228309855,4.0,3.0,50.0
5468598,1524144364,1524144397,33,219,12.752995084415925,4.91135854106939,3.0,55.0
5468599,1524144398,1524144415,17,166,41.31851939214844,15.460605592657407,3.0,239.30518345382146
5468600,1524144413,1524144433,20,101,6.806302079411529,3.0,3.0,50.0
5468601,1524144432,1524144451,19,185,8.300720326713092,3.0,3.0,50.0
5468602,1524144453,1524144473,20,216,17.089579395522104,5.0,3.0,50.0
5468603,1524144456,1524144475,19,96,3.6152137312510133,3.0,2.01,5.59310645994832
5468604,1524144466,1524144504,38,162,3.5521597033978494,2.0,2.0,5.688297300654879
5468605,1524144504,1524144522,18,134,18.686699972163215,6.042757097791798,5.0,54.92122445465431
5468607,1524144515,1524144524,9,158,4.642039206161276,3.0,2.0,5.911844969072164
5468608,1524144519,1524144533,14,179,2.8546766442403704,2.4767644623905793,2.0,4.498851011489884
5468609,1524144525,1524144534,9,181,4.560516462648346,2.0,2.0,14.770589518229118
5468611,1524144535,1524144580,45,143,5.54177392804899,3.2999780801583376,2.0,12.197604620281812
5468614,1524144579,1524144624,45,193,7.753421530400221,3.0,2.0,50.0
5468619,1524144617,1524144625,8,191,7.916096479972413,3.0,2.0,50.0
5468620,1524144621,1524144640,19,114,6.640004276473666,3.0,2.0,48.90903025546444
5468621,1524144628,1524144668,40,18,51.84027276947857,50.53510151295824,20.817451319716024,111.0
5468622,1524144667,1524144682,15,260,17.46625663928628,6.0,5.0,52.42509121719959
5468623,1524144681,1524144697,16,192,10.387413081694943,5.0,3.18,21.0
5468624,1524144697,1524144703,6,214,8.37467424328344,4.0,1.0,35.529143439882155
5468625,1524144701,1524144729,28,64,51.63918569651348,50.0,45.77714021164021,55.0
5468626,1524144728,1524144760,32,168,11.306355151551557,5.0,4.0,30.0
5468627,1524144759,1524144790,31,148,15.630301859464298,10.0,1.0,50.37546478260869
5468628,1524144790,1524144796,6,130,22.239590391182233,10.630896166424423,5.0,55.0
5468629,1524144796,1524144801,5,126,4.147310010896449,3.4389276,1.8977472727272735,8.33420114135742
5468630,1524144801,1524144843,42,87,4.0391801900157045,3.0,3.0,5.580225333333326
5468631,1524144841,1524144858,17,187,20.36189121265418,10.0,3.0,54.0
5468632,1524144857,1524144867,10,133,8.168461052000202,3.0,3.0,50.0
5468633,1524144865,1524144880,15,43,53.72670966799704,50.0,41.0,111.0
5468634,1524144879,1524144887,8,164,4.675662757624863,3.0,2.2539457896325783,14.588670139888805
5468635,1524144884,1524144896,12,74,11.206226383735922,5.0,3.0,48.541263157894676
5468636,1524144897,1524144905,8,123,7.449511175052166,3.0,2.0,30.78038619774425
5468637,1524144903,1524144913,10,187,7.5676092539675315,3.0,1.5,38.33486444444439
5468638,1524144913,1524144923,10,150,8.146781923990773,3.0,2.0,50.0
5468639,1524144922,1524144952,30,121,22.22476328993129,15.0,3.0,50.0
5468640,1524144951,1524144981,30,154,18.786529120926225,5.100240435207456,3.0,50.0
5468641,1524144975,1524144994,19,151,21.08809050859145,7.855730965099532,3.0,56.646913170131924
5468642,1524144993,1524145022,29,251,8.30684812305139,1.0,1.0,41.0
5468643,1524145021,1524145045,24,155,17.80580061883265,6.0,3.0,55.0
5468644,1524145042,1524145049,7,135,11.903035090438856,3.0,3.0,50.0
5468645,1524145049,1524145056,7,127,4.578343262010273,3.0,2.0,16.501593333333332
5468646,1524145056,1524145075,19,98,16.319355291754416,3.0,3.0,54.0
5468647,1524145074,1524145081,7,150,42.38342294869279,50.0,4.0,100.0
5468648,1524145080,1524145122,42,120,5.854485009253529,3.0,1.5,20.751604958677675
5468649,1524145120,1524145144,24,161,25.711795415003444,16.140172228202378,4.0,58.25928122438879
5468650,1524145143,1524145157,14,121,14.262508198541672,10.0,3.0,50.0
5468651,1524145156,1524145160,4,93,6.676159943344952,3.0,3.0,30.236136531365194
5468652,1524145159,1524145165,6,141,3.2466912087404136,3.0,2.0,3.0
5468653,1524145164,1524145180,16,230,9.048360429154524,3.0,1.0,50.0
5468654,1524145174,1524145183,9,127,6.132796375555674,3.0,2.0,20.536557014925368
5468655,1524145184,1524145190,6,28,35.354424613867685,30.0,0.0,102.5258351020408
5468656,1524145188,1524145201,13,164,3.418663328744221,3.0,2.0,5.0
5468657,1524145199,1524145213,14,199,7.392445262598742,3.0,2.0,29.40036922980233
5468659,1524145214,1524145235,21,95,10.05920475569196,2.9060723716381416,2.0,51.91391291409791
5468660,1524145225,1524145245,20,93,6.808322466638282,3.0,2.0,36.756338235294095
5468661,1524145236,1524145257,21,118,11.133717599127133,3.0,3.0,55.0
5468662,1524145255,1524145261,6,172,11.353531984672767,4.0,1.0,40.0
5468663,1524145259,1524145276,17,13,56.88297093051796,50.0,40.876815351868736,106.55161363636363
5468664,1524145276,1524145281,5,145,6.39192109763099,3.0,2.0,26.480141970100078
5468665,1524145280,1524145289,9,86,5.913289421429116,3.0,3.0,20.0
5468666,1524145288,1524145307,19,40,8.707805465982124,3.0,3.0,20.974922608572786
5468667,1524145305,1524145315,10,74,24.80453342020679,9.744972707427754,4.0,59.25989873046291
5468668,1524145312,1524145324,12,164,8.068401772348423,3.0,2.0,50.0
5468669,1524145319,1524145330,11,99,10.027866554950327,3.0,2.0,50.0
5468670,1524145324,1524145347,23,156,3.9808596978109643,2.0,2.0,5.0
5468671,1524145346,1524145378,32,182,18.358951629071168,5.0,3.0,54.16946525327967
5468672,1524145378,1524145393,15,236,12.227069698468878,4.0,1.0,49.982146938775436
5468673,1524145390,1524145402,12,150,4.5473809187324,3.0,2.0,12.4075958823529
5468674,1524145401,1524145420,19,114,11.320777339223683,4.0,3.0,51.9
5468675,1524145422,1524145437,15,61,25.780942713519078,20.0,0.0,51.9
5468676,1524145434,1524145440,6,26,35.96165289061445,30.0,16.39076,99.22672221858191
5468677,1524145440,1524145454,14,150,6.744598389153036,5.0,2.0,10.0
5468678,1524145452,1524145474,22,124,12.701559657110838,4.0,1.0,50.45374883547031
5468679,1524145473,1524145479,6,164,29.07039284786643,30.0,2.0,55.0
5468680,1524145479,1524145482,3,58,13.366896720602526,11.325701977138461,3.0,21.80272022779043
5468681,1524145491,1524145529,38,147,13.213153295869608,5.0,2.0,51.9
5468682,1524145527,1524145566,39,128,20.53188073906778,9.97665108271189,3.107971601731602,60.0
5468683,1524145559,1524145612,53,177,16.965847983803116,5.0,3.0,53.57629094520033
5468684,1524145611,1524145622,11,160,25.39489058720554,17.0,5.0,55.0
5468685,1524145621,1524145659,38,208,8.463247047650137,5.0,1.5,20.0
5468686,1524145656,1524145668,12,135,11.304882203804636,5.0,3.0,50.0
5468687,1524145666,1524145677,11,163,14.027164503759733,5.0,2.0,50.1
5468688,1524145675,1524145705,30,146,4.538089886729814,3.0,1.0,13.628262044693859
5468689,1524145703,1524145715,12,183,11.164614474923017,5.0,2.0,50.05560756850078
5468690,1524145713,1524145730,17,156,14.683504723141885,4.0,2.0,50.1
5468691,1524145729,1524145735,6,223,10.98849966909808,5.0,1.0,50.0
5468692,1524145735,1524145743,8,92,13.90870522213132,10.217271068029511,2.0,41.0
5468693,1524145740,1524145758,18,154,2.8443132816410825,3.0,1.0,4.107079800892919
5468694,1524145757,1524145770,13,165,13.284348298122447,5.0,3.0,53.847285953073694
5468695,1524145764,1524145778,14,77,6.066168951851831,3.0,2.0,16.04315395326773
5468696,1524145787,1524145791,4,58,27.934054999187858,23.48956738929261,0.0,54.51249904977374
5468697,1524145791,1524145799,8,124,7.2495890274855785,5.0,2.0000000961032294,23.49190666665048
5468698,1524145798,1524145843,45,78,6.1853673502911874,3.0,1.0,29.545337269372652
5468699,1524145842,1524145860,18,210,21.689335042783153,8.546236257992735,1.0,51.77650347424304
5468700,1524145859,1524145864,5,164,10.831295854454392,4.0,2.010001,50.07816572408665
5468701,1524145862,1524145876,14,99,11.584521152821411,3.0,2.4968775438596498,50.0
5468702,1524145875,1524145885,10,19,53.54896293995138,53.232225966939495,20.0,100.97197037037037
5468703,1524145884,1524145890,6,171,7.298099439228082,3.4238688206388206,2.0,40.984763234558926
5468704,1524145890,1524145896,6,198,3.7725085285944444,2.0,2.0,5.861338402740406
5468705,1524145894,1524145917,23,43,4.450232996264513,3.0,3.0,9.310004057110948
5468706,1524145902,1524145920,18,69,6.104546095720691,3.0,2.0,31.92665166666636
5468707,1524145915,1524145941,26,103,22.223407713722423,10.0,3.0,50.0
5468708,1524145940,1524145951,11,188,14.843680167751737,5.0,2.3030849353239375,50.48879005847951
5468709,1524145950,1524145964,14,110,6.910284391329099,2.7231945751795887,2.0,30.10587355555555
5468710,1524145963,1524145994,31,171,9.191599200280228,3.0,2.0,35.0
5468711,1524145993,1524146036,43,212,12.582137242307677,5.0,2.0,51.412602477459046
5468712,1524146033,1524146046,13,157,14.59825067490863,5.292103419354839,3.18,54.08819093702962
5468713,1524146042,1524146047,5,164,22.20248207993891,8.959498608779445,2.0,55.0
5468714,1524146045,1524146051,6,9,66.23986059674436,51.62253684737779,21.11278355796976,192.0
5468715,1524146047,1524146055,8,132,3.0435687809062224,3.0,2.0,4.0
5468716,1524146054,1524146070,16,103,8.643934246334883,4.657705141714032,2.0,55.0
5468717,1524146058,1524146084,26,111,4.181913614214884,2.0,2.0,8.045091358024688
5468718,1524146084,1524146092,8,147,8.691944995647297,4.000000001,2.0,41.0
5468719,1524146090,1524146097,7,71,4.875653792247326,3.0,2.0,20.10606349821104
5468720,1524146094,1524146102,8,179,9.226806636186904,3.0,2.0,53.54257107506925
5468721,1524146101,1524146107,6,66,7.154788410733872,3.0,2.0137246470151102,25.977602195783536
5468722,1524146104,1524146136,32,104,3.3899947919897166,2.516,2.0,7.915237354085558
5468723,1524146137,1524146147,10,196,13.800810401815989,5.0,2.0,50.0
5468724,1524146143,1524146153,10,140,4.132132238674806,3.0,2.0,5.0
5468725,1524146153,1524146176,23,170,11.392878724297468,3.1,2.0,50.0
5468726,1524146174,1524146194,20,161,18.464110591834746,5.0,2.0,72.03469548610055
5468727,1524146193,1524146222,29,48,20.72680995049128,10.0,2.0,55.0
5468728,1524146222,1524146236,14,122,11.203011660631022,5.0,3.2,49.409563272526505
5468729,1524146235,1524146244,9,234,10.064775931791392,2.0,1.0,50.0
5468730,1524146242,1524146251,9,176,8.87907126448668,3.18,1.0,50.0
5468731,1524146244,1524146256,12,12,4.627920829020213,3.081505684729064,3.0,12.785674108914092
5468732,1524146254,1524146262,8,52,12.906454236930362,4.0,3.0,54.53910758343693
5468733,1524146262,1524146275,13,95,5.135506580624678,3.0,2.0,20.0
5468734,1524146274,1524146282,8,169,7.659784324429396,2.0,2.0,40.0
5468735,1524146279,1524146291,12,127,3.7394313475864043,2.0,2.0,7.0707710126389935
5468736,1524146287,1524146300,13,98,5.571815613845321,3.0,2.0,30.0
5468737,1524146291,1524146309,18,101,6.537844902273712,2.584986623730493,2.0,29.995084684684596
5468739,1524146318,1524146323,5,90,52.296423509790415,54.1988572744507,50.0,54.99840747971625
5468740,1524146322,1524146328,6,125,4.453105646372389,3.009101911388059,2.0,5.0
5468741,1524146327,1524146355,28,138,16.505658168610772,2.5376144197803834,2.0,111.2
5468742,1524146355,1524146362,7,175,10.9788338573795,5.0,2.0,45.27859905927522
5468743,1524146360,1524146374,14,165,7.96175353277022,3.0,2.0,40.61678812619216
5468744,1524146370,1524146387,17,71,5.46888021588272,3.0,2.0,20.482519457013538
5468745,1524146385,1524146395,10,181,7.825714182101063,2.058973892773893,2.0,40.444888523176985
5468746,1524146394,1524146413,19,114,10.078901607440685,4.0,3.0,51.9
5468747,1524146413,1524146425,12,175,7.214747748472445,4.0,2.0,37.90646756756745
5468748,1524146423,1524146443,20,39,39.13440026793332,36.59113842312699,20.0,91.0
5468749,1524146443,1524146474,31,280,12.951484712592327,5.339392013888889,5.0,40.0
5468750,1524146474,1524146482,8,164,31.35199142226023,17.382561111111112,5.0,87.58864325370503
5468751,1524146482,1524146509,27,184,4.904157977109818,4.0,3.0,8.04776106519548
5468752,1524146511,1524146526,15,213,11.691404424850834,5.0,2.0,50.0
5468753,1524146525,1524146532,7,188,7.528738059921654,3.538671449777338,2.0,40.0
5468754,1524146531,1524146581,50,165,8.430339635521952,2.0,2.0,48.085858235293976
5468755,1524146580,1524146597,17,165,19.197343731899505,6.761923118917898,5.0,99.0
5468756,1524146594,1524146601,7,146,12.167486567965547,4.065083169992025,2.5034406692838465,20.246812307149757
5468757,1524146600,1524146615,15,65,6.421587134833157,3.0,2.0880389828400894,39.05130996309951
5468758,1524146614,1524146633,19,114,14.120898887644339,5.0,3.29,59.777593333333314
5468759,1524146633,1524146645,12,279,11.625176117028337,4.924494864416056,1.0,55.0
5468760,1524146643,1524146664,21,126,5.498186144486521,3.0,2.0,5.0
5468761,1524146664,1524146672,8,214,9.966370942812778,4.000000001,2.0,50.0
5468762,1524146667,1524146682,15,95,8.293568280170394,3.0,2.0,50.0
5468763,1524146677,1524146683,6,107,8.17972874172703,3.0,2.0189177483279663,50.0
5468764,1524146681,1524146692,11,164,4.353697086665404,2.0,2.0,8.173447649994372
5468765,1524146693,1524146715,22,204,28.707156696118027,10.2350231824906,3.0,91.0
5468766,1524146712,1524146726,14,185,5.652573042363986,3.0,2.0,21.0
5468767,1524146726,1524146752,26,90,11.72199008262891,5.0,3.0,51.13131066666666
5468768,1524146752,1524146756,4,175,14.528030273992258,5.0,2.0,60.0
5468769,1524146755,1524146762,7,82,5.1100154934706215,4.0,2.0,5.0
5468770,1524146760,1524146775,15,169,5.509888693478585,2.0,2.0,40.0
5468771,1524146774,1524146796,22,146,11.67071953636133,3.0,2.0,50.0
5468772,1524146796,1524146804,8,242,15.304682817814315,5.0,1.0,50.41873204285714
5468773,1524146804,1524146831,27,88,4.184712371816212,2.5055556875,2.0,7.821447824279378
5468774,1524146832,1524146840,8,180,15.990552826352765,5.0,2.0,53.976803409165825
5468775,1524146839,1524146847,8,147,6.683660121172097,3.0,2.0,50.0
5468777,1524146847,1524146857,10,160,5.536263393523024,3.0,3.0,14.104215210302195
5468778,1524146852,1524146859,7,12,48.90179779810526,41.0,18.0,97.06477837423311
5468779,1524146854,1524146868,14,209,3.6391248023012355,2.0,2.0,5.389417
5468780,1524146865,1524146886,21,257,3.810724379954347,2.77499818404908,1.5,15.000000000685977
5468781,1524146869,1524146903,34,151,8.139228792065458,2.8970722352941176,1.0,46.422916045844325
5468782,1524146901,1524146974,73,209,10.623876613758464,4.0,2.2518493333333334,50.040964271146095
5468783,1524146972,1524147009,37,205,43.27286366119103,50.0,15.0,90.69381983471072
5468784,1524147008,1524147022,14,251,15.012909230366931,6.70425344,5.0,49.897951999999975
5468785,1524147020,1524147038,18,106,12.862621969741785,5.892451388888888,4.0,50.0
5468786,1524147038,1524147057,19,241,9.516915908744746,3.8010823332794192,1.0,51.092625141136615
5468787,1524147055,1524147069,14,200,9.898631431242409,4.0,2.742481411764706,50.0
5468788,1524147068,1524147095,27,288,6.983080374258593,1.0,1.0,50.0
5468789,1524147093,1524147126,33,161,21.35959237971931,9.310000001,4.0,55.03023050319726
5468790,1524147126,1524147169,43,186,15.195376619296825,6.0,3.29,50.0
5468791,1524147168,1524147173,5,200,8.496347107798005,3.9692588744588733,2.1297029906325067,41.0
5468792,1524147173,1524147183,10,194,5.79063886458339,2.0,2.0,20.0
5468793,1524147181,1524147196,15,84,5.218115209693115,3.0,2.0,14.790971301276947
5468794,1524147193,1524147199,6,213,23.907970503359344,5.0,3.1,55.0
5468795,1524147197,1524147265,68,68,3.8302634387059524,2.708246717859797,1.0,7.876017500790823
5468796,1524147265,1524147272,7,214,18.627192607848,5.0,3.858663703703704,60.0
5468797,1524147272,1524147313,41,154,8.010819732123226,3.6,2.0,35.00198560661762
5468798,1524147313,1524147326,13,214,15.620624100455405,6.3239914772727275,3.0,54.86816438743044
5468799,1524147325,1524147364,39,152,6.122983701895528,3.0,2.0,23.6
5468800,1524147362,1524147380,18,232,18.750383199034054,5.0,1.0,90.00493565552502
5468801,1524147374,1524147383,9,259,25.19060975790243,5.125,1.0,100.0
5468802,1524147381,1524147387,6,203,4.027358053777119,2.0,2.0,17.338399999999996
5468803,1524147384,1524147399,15,97,3.6252610132359364,3.0,2.0,5.0
5468805,1524147396,1524147407,11,105,8.774604818075847,3.0,2.0,36.12410143057588
5468806,1524147406,1524147413,7,53,42.77834715799308,50.0,20.0,54.72063507709235
5468807,1524147410,1524147418,8,205,7.244361485873624,4.980118332839719,2.1,16.760542682653014
5468808,1524147415,1524147426,11,191,3.542811896425999,2.0,2.0,6.431749666614973
5468809,1524147420,1524147439,19,110,7.586343607447381,3.0,2.0,38.38179167224791
5468810,1524147436,1524147450,14,192,16.04424577312823,5.0,2.0,54.6
5468811,1524147446,1524147456,10,77,8.089916995678106,3.0,2.132664734883721,41.0
5468812,1524147456,1524147477,21,83,5.651309447663931,2.0,2.0,23.770282675
5468813,1524147476,1524147483,7,210,14.337708877834094,5.0,3.0,50.64476800904976
5468814,1524147481,1524147487,6,68,4.775032528886727,3.0,2.0,13.449287817074424
5468815,1524147487,1524147498,11,64,8.388063803903314,3.563383843537415,2.4003958068459657,24.273305673758845
5468816,1524147498,1524147507,9,165,6.754874730662532,3.0,2.0,20.0
5468817,1524147507,1524147525,18,98,7.923078357132968,3.0,2.0,27.726377941176462
5468818,1524147525,1524147536,11,139,12.864376704174104,5.0,2.0,41.0
5468819,1524147531,1524147566,35,77,11.319832253091139,5.0,4.0,50.0
5468820,1524147564,1524147590,26,145,14.584655826685806,5.766047045161385,5.0,55.0
5468821,1524147591,1524147634,43,192,13.465154643357803,5.0,3.0,47.216694585278496
5468822,1524147631,1524147655,24,156,15.550940598457585,5.0,3.696222869481766,59.647138102910745
5468823,1524147655,1524147690,35,238,8.94167933292414,4.0,1.0,48.47665657573919
5468824,1524147689,1524147715,26,205,17.636450755168315,5.117171600000001,1.0,53.87387105126875
5468825,1524147715,1524147721,6,174,25.46217023602461,16.60073076923076,4.000000000384528,55.0
5468826,1524147721,1524147738,17,134,7.299449927643663,4.0,1.0,9.90920013344689
5468827,1524147739,1524147749,10,160,6.192980045653281,3.0,2.0,26.942725423176924
5468828,1524147748,1524147763,15,84,5.6877718973927305,3.0,2.0,12.55121991047155
5468829,1524147762,1524147773,11,170,8.527778484922406,3.603017441860465,2.0,50.0
5468830,1524147772,1524147816,44,180,19.527013261947737,8.5898752,4.0,50.0
5468831,1524147814,1524147858,44,211,14.169594259844528,4.9,3.0,59.663871644152685
5468832,1524147857,1524147864,7,157,19.700090588232744,8.0,4.9,55.0
5468833,1524147865,1524147871,6,125,3.890441564037758,3.0,2.0,6.315163106342961
5468834,1524147871,1524147877,6,198,4.219396846266225,2.0,2.0,9.331617487904532
5468835,1524147876,1524147889,13,101,7.3005898860633955,3.0,2.0,25.488446022559344
5468836,1524147886,1524147933,47,113,12.4223575615901,2.912775312406837,2.0,79.51954205608051
5468837,1524147930,1524147943,13,210,17.181122472524308,8.760684823638927,4.0,50.0
5468838,1524147941,1524147967,26,158,13.622268029738661,5.710806723065257,2.0,51.06556352833824
5468839,1524147966,1524147981,15,210,8.017833018843938,4.307305063673464,2.0,35.73328777777777
5468840,1524147980,1524147995,15,76,7.905513822874949,3.0,2.1970939063661135,40.26879689503216
5468841,1524147993,1524148002,9,121,9.092156679064026,2.075815102739726,2.0,48.28239488300311
5468842,1524148000,1524148026,26,88,6.738006050959639,3.0,2.0,36.13728468468461
5468843,1524148025,1524148031,6,164,15.352343879262843,5.786594415381343,2.0,54.85664496989981
5468844,1524148030,1524148051,21,109,9.923580956135291,3.0,2.0,51.090603267616345
5468845,1524148049,1524148063,14,189,15.248872728114426,5.0,2.0,55.0
5468846,1524148061,1524148087,26,162,11.955520458530572,5.0,3.0,51.20105776666665
5468847,1524148084,1524148099,15,63,7.136756720363043,5.61797668450523,3.0,19.084990201805397
5468848,1524148100,1524148108,8,170,11.081420943823128,5.0,2.0,43.35380603313081
5468849,1524148107,1524148117,10,205,28.17324289369822,41.0,1.0,58.82869801052241
5468850,1524148112,1524148129,17,141,22.63488711253326,8.5898752,4.0,55.0
5468851,1524148127,1524148141,14,113,14.747815853135405,4.0,2.0,60.21393086419737
5468852,1524148141,1524148147,6,129,7.181287298846459,4.000000000008335,2.0,41.13921392221026
5468853,1524148147,1524148167,20,168,18.789272123521215,5.0,3.0,55.0
5468854,1524148171,1524148180,9,209,7.735724329138983,2.0,1.0,46.54088175912893
5468855,1524148179,1524148191,12,105,6.005961105779709,4.0,2.0,20.590033579335785
5468856,1524148191,1524148198,7,131,13.944845582002003,3.0,3.0,87.14422238596899
5468857,1524148196,1524148202,6,89,12.967776634244585,4.0,2.0,50.0
5468858,1524148201,1524148210,9,212,4.049832377346172,2.0,1.0,9.644044986197715
5468859,1524148208,1524148221,13,175,9.708220398939758,4.0,2.0,50.0
5468860,1524148213,1524148226,13,97,4.830942893311775,2.560218195812808,2.0,20.517839633027517
5468861,1524148219,1524148234,15,247,4.586976060150943,4.0,2.0,7.12639599182931
5468862,1524148234,1524148247,13,21,18.955091468499415,16.5188,0.0,78.56792505937875
5468863,1524148245,1524148265,20,288,8.21536125049452,5.0,2.0,33.78310871794866
5468864,1524148264,1524148281,17,197,8.969331940414099,4.0,2.0,46.21520071258906
5468865,1524148280,1524148294,14,224,15.411542683107612,5.0,3.0,55.0
5468866,1524148293,1524148365,72,112,5.427244893470912,3.0,2.0,19.66975067588934
5468867,1524148364,1524148373,9,213,36.07538025516103,30.0,8.5898752,96.45986086956519
5468868,1524148374,1524148383,9,188,7.820333237457496,5.0,4.0,20.0
5468869,1524148382,1524148401,19,222,6.975011235717375,3.0,1.0,23.913229752066037
5468870,1524148400,1524148412,12,163,7.836734529277463,5.0,1.5,21.0
5468871,1524148402,1524148421,19,61,6.633543513476899,3.0,2.0750583685650335,22.896527504809914
5468872,1524148419,1524148433,14,178,9.374347872841588,3.0,2.0,52.33797181996085
5468873,1524148433,1524148444,11,102,8.007988972428969,2.411256456428947,2.0,41.55519387755101
5468874,1524148440,1524148448,8,170,7.1190007529626005,3.0,2.0,34.764126126126044
5468875,1524148444,1524148459,15,113,5.248177819832616,3.0,2.0,22.0
5468876,1524148457,1524148485,28,106,5.7564821986543295,3.0,2.0,20.0
5468877,1524148485,1524148489,4,150,11.823644832964971,5.0,2.0,50.0
5468878,1524148488,1524148496,8,151,3.465099228233555,3.0,2.0,5.521674825078107
5468879,1524148493,1524148503,10,70,2.398239350739801,2.0,2.0,4.7774487894736835
5468880,1524148500,1524148509,9,270,5.502892293605277,2.0,1.0,29.418722523368334
5468881,1524148507,1524148516,9,197,10.04987581123458,2.0,2.0,59.46646278158667
5468882,1524148510,1524148529,19,156,6.953864835124016,3.0,3.0,14.303639805440474
5468883,1524148517,1524148530,13,190,5.5975902583215476,2.0,2.0,20.0
5468884,1524148524,1524148544,20,28,34.520404103856904,30.225241109112428,18.175992268291814,55.0
5468885,1524148535,1524148600,65,83,6.118953664070905,3.089736284506342,3.0,17.056409638554168
5468886,1524148599,1524148617,18,215,26.33628018666932,18.0,5.0,58.309944756048104
5468887,1524148620,1524148632,12,204,22.675518594066133,8.5898752,5.0,77.181867368421
5468888,1524148630,1524148648,18,136,6.302329758161302,3.0,2.0,37.33964864864859
5468889,1524148647,1524148660,13,128,13.316480167708221,4.9,2.0,41.0
5468890,1524148659,1524148685,26,94,11.036340112121279,3.0,2.0,57.36564058260595
5468891,1524148685,1524148711,26,275,15.652789018767708,20.0,1.0,51.0
5468892,1524148710,1524148723,13,197,8.96728155400213,3.0,2.0,41.0
5468893,1524148723,1524148736,13,72,10.3531694864259,3.477948254518445,2.0,50.42099786640406
5468894,1524148734,1524148751,17,198,5.765267619342937,2.903791687041565,2.0,32.02499099099067
5468895,1524148750,1524148760,10,169,19.966964313200403,14.941407616127385,5.0,50.71821417738677
5468896,1524148759,1524148773,14,111,5.803825093366712,3.0,2.0,17.84349277777778
5468897,1524148771,1524148787,16,109,8.476273008502885,3.0,1.0,50.0
5468898,1524148788,1524148799,11,133,13.49240913376512,5.0,2.0,55.0
5468899,1524148799,1524148826,27,87,5.356244732825947,3.0,2.0,20.0
5468900,1524148824,1524148830,6,212,9.661570514588384,4.948624482758621,2.0,34.6839773368421
5468901,1524148829,1524148838,9,169,13.732203095837484,5.141832094418747,3.0,55.0
5468902,1524148831,1524148870,39,116,3.044651538565176,2.0,2.0,5.758202368685185
5468903,1524148870,1524148889,19,201,18.366963612971773,5.0,2.0,58.08354746750032
5468904,1524148888,1524148897,9,167,10.039874483815012,5.0,2.0,53.5162422561084
5468905,1524148893,1524148901,8,175,7.8547003222218486,2.0,2.0,48.45563511730232
5468906,1524148898,1524148911,13,68,49.40728807252325,50.0,24.270550282277256,55.0
5468907,1524148907,1524148928,21,241,7.727535452031176,4.0,1.0,42.79987463601936
5468908,1524148932,1524148938,6,251,14.490971491913989,5.0,1.0,50.0
5468909,1524148937,1524148946,9,173,5.57896083686767,3.0,2.0,19.826998709677323
5468910,1524148945,1524148965,20,168,10.687364668027424,4.0,1.0,50.0
5468911,1524148967,1524148980,13,18,44.08366757635552,50.0,22.03366838502757,55.0
5468912,1524148979,1524148992,13,230,16.157989221793112,5.0,1.0,50.0
5468913,1524148992,1524149006,14,122,12.932570145845055,3.0,2.0,48.14216399008802
5468914,1524149005,1524149022,17,111,18.59947390236961,5.0,2.198196922956773,50.0
5468915,1524149022,1524149057,35,99,49.511720453793814,50.0,20.0,90.0
5468916,1524149056,1524149062,6,192,14.859072803735337,5.0,3.0,50.0
5468917,1524149063,1524149074,11,202,19.572387066117304,8.5898752,4.0,50.0
5468918,1524149072,1524149088,16,159,7.87618573127029,3.0,2.0,41.0
5468919,1524149086,1524149103,17,101,12.448765714154929,5.0,3.0,50.0
5468920,1524149101,1524149133,32,165,11.254843357235975,4.0,2.0,50.0
5468921,1524149132,1524149148,16,166,15.184743157277273,5.0,2.0,50.25001867956249
5468922,1524149146,1524149154,8,177,27.163680784858776,20.0,3.0,55.0
5468923,1524149155,1524149161,6,169,5.702795709118876,2.0,2.0,29.88098738738728
5468924,1524149160,1524149173,13,75,52.866995501352775,55.0,22.0,55.0
5468925,1524149173,1524149179,6,141,7.692886803287509,4.0,2.0,30.0
5468926,1524149177,1524149187,10,83,4.026820243325816,3.0,2.0,6.95252393088116
5468927,1524149184,1524149193,9,123,5.141534464516496,2.0,2.0,20.0
5468928,1524149192,1524149201,9,99,9.52383802782703,5.0,5.0,50.0
5468929,1524149199,1524149211,12,94,8.25598260293567,5.0,5.0,50.0
5468930,1524149210,1524149232,22,128,2.9195138169184656,3.0,2.0,5.0
5468931,1524149231,1524149261,30,242,14.953397319770028,5.0,2.0,52.939357028972054
5468932,1524149260,1524149279,19,95,39.1149397100345,50.0,0.0,57.62980463630175
5468933,1524149277,1524149283,6,80,19.27294075810477,3.0,2.0,51.78377039338223
5468934,1524149282,1524149326,44,235,7.07304928060908,4.83626525974026,1.0,20.0
5468935,1524149325,1524149358,33,178,22.885070577468174,18.0,5.0,51.9
5468936,1524149356,1524149365,9,195,16.87024349853191,5.0,4.163573903654486,55.0
5468937,1524149361,1524149397,36,176,5.979151721929073,4.0,2.0,15.902953565140713
5468938,1524149395,1524149410,15,215,19.619600578992017,5.0,4.0,55.0
5468939,1524149409,1524149418,9,163,6.004343882638044,4.0,2.85495704528582,20.0
5468940,1524149417,1524149460,43,88,6.861714172687158,3.0,2.0000000458141542,41.0
5468941,1524149461,1524149471,10,134,34.024126289720265,20.0,2.006645330691107,90.0
5468942,1524149471,1524149478,7,246,7.779362258327372,4.0,1.0,38.31759841100414
5468943,1524149479,1524149488,9,169,6.50047507780886,3.0,2.0,30.573758620689567
5468944,1524149487,1524149496,9,103,5.326908569998483,3.0,2.0,17.95612764705882
5468945,1524149492,1524149497,5,202,21.216501617489136,5.0,3.0,55.0
5468946,1524149495,1524149517,22,103,2.6610884264952333,2.4959868714391873,2.0,5.0
5468947,1524149516,1524149531,15,226,6.196808565412949,4.0,4.0,5.0
5468948,1524149532,1524149549,17,160,7.074779207243471,3.0,2.0,50.0
5468949,1524149548,1524149583,35,172,15.549956539628658,5.0,2.0,53.65292989690721
5468950,1524149583,1524149594,11,130,20.540317597591716,10.0,4.128875711840672,50.12826441716088
5468951,1524149592,1524149598,6,198,11.047151503448328,4.0,2.0,50.0
5468952,1524149598,1524149617,19,74,4.054367315824534,2.6988411600665807,2.0,5.0
5468953,1524149612,1524149624,12,191,18.67619702044725,5.010157774968395,3.0,55.0
5468954,1524149622,1524149648,26,172,15.182365016183615,4.000000000100582,3.0,50.0
5468955,1524149648,1524149657,9,40,50.31896084514274,50.0,17.30301428571429,100.0
5468956,1524149657,1524149677,20,233,10.119200551129724,5.0,1.0,50.0
5468957,1524149676,1524149687,11,150,13.170223478705356,4.206656246153846,2.0,60.0
5468958,1524149687,1524149727,40,158,13.555783871993725,4.1457861428987,2.0,50.0
5468959,1524149727,1524149735,8,217,16.5149588248215,5.0,1.0,59.091275220372175
5468960,1524149733,1524149738,5,98,6.45312244282971,3.0,2.0,39.71612199723376
5468961,1524149736,1524149748,12,97,6.688228985747755,2.350594360655738,1.0,50.0
5468962,1524149748,1524149793,45,59,53.28951580025585,50.0,0.0,100.0
5468963,1524149792,1524149812,20,173,20.526643917827432,9.310000001,5.0,50.0
5468964,1524149812,1524149816,4,134,21.7839559964404,9.618514157320327,5.0,55.0
5468965,1524149815,1524149821,6,115,5.717535777768628,4.420082000000002,3.0,9.047596254334438
5468966,1524149820,1524149833,13,97,5.9537435909334295,3.0,2.0,20.167075294117637
5468967,1524149831,1524149860,29,198,11.840053008747734,5.0,2.0,50.0
5468968,1524149858,1524149870,12,202,17.493902229595196,5.0,2.0,57.78796313948259
5468969,1524149869,1524149879,10,171,12.042977314686398,4.0,3.0,50.0
5468970,1524149883,1524149888,5,96,4.9087846160995054,3.0,2.0,20.0
5468971,1524149887,1524149926,39,65,48.47831521379538,50.0,20.0,84.88511459353572
5468972,1524149926,1524149936,10,171,18.028597277537347,5.0,4.0,50.84129236363635
5468973,1524149934,1524149948,14,111,8.257809659584872,4.827046545627499,2.0,41.65698333333319
5468974,1524149948,1524149956,8,146,6.39052920373624,3.0,2.0,30.043155555555494
5468975,1524149957,1524150003,46,81,9.414680080947809,2.820391096742104,2.0,51.213935114942515
5468976,1524150002,1524150008,6,188,63.32708747935756,5.0,3.335046159037559,58.563367826086946
5468977,1524150007,1524150015,8,86,7.8417899321453515,3.339704235818677,2.3687365576672756,27.069931914893527
5468978,1524150014,1524150043,29,51,40.772563098649485,24.7394054054054,20.0,88.69749687835974
5468979,1524150042,1524150048,6,277,14.14040692198536,6.858716279973358,5.0,50.0
5468980,1524150047,1524150055,8,19,10.499668140155167,3.4344701345061797,2.038874197653521,52.74842228571428
5468981,1524150054,1524150088,34,195,5.483715874427961,4.000000001,2.0,13.756471655328777
5468982,1524150087,1524150095,8,231,12.025409191516486,5.0,2.0,41.0
5468983,1524150092,1524150103,11,136,7.0795139449585465,3.0,2.0,40.0
5468984,1524150102,1524150124,22,177,9.744542761111669,3.0,2.0,60.30500457142829
5468985,1524150123,1524150144,21,100,13.163870118023006,7.887715882342558,4.0,50.0
5468986,1524150144,1524150153,9,188,27.183124221516557,18.0,4.0,55.0
5468987,1524150152,1524150229,77,101,15.137466647888475,8.118168507392342,5.0,50.0
5468988,1524150228,1524150253,25,208,40.12343019858317,50.0,4.0,65.20724111970424
5468989,1524150252,1524150258,6,150,11.928623168705432,5.0,4.1611971506044805,50.0
5468990,1524150257,1524150274,17,211,6.4939369581941255,4.0,1.0,21.478985399999946
5468991,1524150274,1524150279,5,86,10.197316304207835,4.0729521061821,2.758501620370371,50.0
5468992,1524150278,1524150293,15,60,9.7109174567232,4.0,2.0,50.83982873749999
5468993,1524150292,1524150324,32,116,50.564240241717584,50.0,21.0,112.0
5468994,1524150321,1524150332,11,28,45.15722586395299,50.0,22.060020933977455,50.0
5468995,1524150331,1524150337,6,13,57.89738383954967,55.0,52.59064093767463,84.53084884467263
5468996,1524150336,1524150344,8,153,8.573878680287022,5.0,4.0,29.882163243243202
5468997,1524150342,1524150370,28,134,4.0669833872781025,2.0,2.0,6.399780137383896
5468998,1524150371,1524150393,22,157,14.874411306495308,5.482113617563649,4.0,50.0
5468999,1524150395,1524150414,19,52,34.1159560799841,33.47315686406965,7.071957601238457e-05,55.0
5469000,1524150414,1524150420,6,166,17.959929730469987,9.904781562499998,4.0,50.0
5469001,1524150419,1524150428,9,287,3.5978617742763714,1.0,1.0,16.482378289473633
5469002,1524150426,1524150444,18,155,9.801442392073788,3.0,3.0,51.98233360995849
5469003,1524150442,1524150465,23,169,10.071829138760132,3.0,3.0,55.23617856480412
5469004,1524150466,1524150473,7,154,17.02527372098479,5.650456935893209,2.1,55.0
5469005,1524150469,1524150479,10,150,9.695808460038338,5.0,3.0,23.175024619533986
5469006,1524150479,1524150489,10,87,3.9172331977932053,2.5424427032019703,2.0,3.1583679447188806
5469007,1524150487,1524150492,5,168,12.395049449685938,4.0,3.0,55.0
5469008,1524150491,1524150510,19,109,4.823055393528163,2.0,2.0,10.71885812499989
5469009,1524150509,1524150525,16,155,9.713472349070448,4.0,3.0,49.21749933433299
5469010,1524150523,1524150541,18,81,16.117937677954743,6.090793438456116,4.0,50.365898701298704
5469011,1524150540,1524150550,10,149,12.459385084475556,4.0,2.2358781296382144,50.0
5469012,1524150548,1524150568,20,98,15.225539152650756,2.581107754601227,2.0,55.0
5469013,1524150567,1524150585,18,111,9.416497934127744,5.0,2.0,45.792521210460066
5469014,1524150586,1524150595,9,296,7.70883808668902,1.0,1.0,45.08036955467438
5469015,1524150592,1524150611,19,172,5.094163114020586,3.0,2.0,20.69461080217152
5469016,1524150611,1524150633,22,144,7.139027058818559,3.0,2.0,31.680279999999886
5469017,1524150634,1524150638,4,165,11.295179681274183,4.990413928571429,1.0,39.44474288332352
5469018,1524150639,1524150651,12,81,2.359634356208659,2.0,2.0,3.0
5469019,1524150646,1524150659,13,89,6.282899085478041,3.0,2.0,27.868502218574754
5469020,1524150658,1524150705,47,107,31.094886786696392,4.0,2.0,90.0
5469021,1524150706,1524150716,10,234,17.67976535245625,6.0,3.9150982578397215,55.0
5469022,1524150715,1524150741,26,103,11.376023310828915,4.6159113617944705,2.0,55.0
5469023,1524150741,1524150750,9,144,7.690936874833778,4.0,2.0,41.0
5469024,1524150748,1524150756,8,58,6.320704275122467,3.0,2.0,37.756461333333235
5469025,1524150752,1524150772,20,127,5.562045283990527,2.0,2.0,33.17480764705877
5469026,1524150770,1524150792,22,124,9.819838788147706,5.0,3.0,53.258550268195414
5469027,1524150791,1524150807,16,160,16.44883995243009,5.0,3.0,50.0
5469028,1524150806,1524150815,9,90,8.355766803425666,3.0,2.0,50.0
5469029,1524150815,1524150822,7,186,10.627188770477249,2.5,2.0,52.376746860231115
5469030,1524150821,1524150825,4,65,13.259071002789918,4.0,1.0,55.0
5469031,1524150822,1524150836,14,3,3.7658227848101267,3.883211678832117,3.0,4.0
5469032,1524150835,1524150845,10,145,8.21062165014416,2.8601210683868543,2.0,49.33803777794399
5469033,1524150843,1524150846,3,50,14.591912511750705,5.0,1.0,55.0
5469034,1524150846,1524150853,7,58,4.42303906788566,2.0,2.0,10.0
5469035,1524150851,1524150868,17,48,17.707172793482275,16.777398975780688,4.2848589891975335,27.936992780060358
5469036,1524150867,1524150882,15,138,11.830143901328533,5.917046354705274,2.0,40.261002817071976
5469037,1524150878,1524150894,16,113,7.091954274736064,4.0,2.0,30.78606490049098
5469038,1524150893,1524150930,37,168,9.720036259340574,5.0,2.0,41.41634872853849
5469039,1524150928,1524150936,8,173,15.471686875544956,5.0,2.0,58.28297894221352
5469040,1524150935,1524150947,12,118,57.05250401240825,55.0,55.0,88.41099082101354
5469041,1524150946,1524151000,54,165,44.48856588569794,50.0,18.0,67.32047444329757
5469042,1524150999,1524151004,5,79,8.320459181802084,6.0,5.0,17.0
5469043,1524151002,1524151007,5,131,16.227020536320616,5.0,3.711579499369361,80.82544434144012
5469044,1524151005,1524151010,5,8,47.088,50.0,31.8,50.0
5469045,1524151008,1524151021,13,89,16.104270284076385,5.0,1.0,65.0
5469046,1524151019,1524151028,9,67,10.931634854951195,5.0,1.0,39.919227172413784
5469047,1524151028,1524151034,6,126,49.88403034420683,65.0,2.028232320991156,65.0
5469048,1524151034,1524151049,15,151,5.857560113972194,3.0,2.0,21.05679
5469049,1524151051,1524151069,18,248,7.174382231329212,2.0,1.0,50.0
5469050,1524151069,1524151076,7,172,12.794103369536755,5.0,3.001,55.0
5469051,1524151085,1524151096,11,161,5.215934018691733,2.373241023051678,2.0,18.49705641669401
5469052,1524151095,1524151104,9,151,11.683416449290565,4.0,2.0,57.8237512242899
5469053,1524151100,1524151106,6,92,5.319588698066573,2.0,2.0,25.7233507
5469054,1524151105,1524151130,25,118,4.232460153156622,2.0,2.0,17.36329399854764
5469055,1524151131,1524151136,5,167,13.91831722213667,5.0,1.0,55.0
5469056,1524151136,1524151172,36,147,3.774078118916192,2.3970858476874306,2.0,5.605913690476188
5469057,1524151169,1524151177,8,203,14.836196647570883,5.0,3.001,50.0
5469058,1524151174,1524151183,9,168,4.034300463559655,3.0,2.0,5.0
5469059,1524151181,1524151193,12,190,5.604665360593719,2.0,2.0,33.232518761877756
5469060,1524151192,1524151203,11,196,8.312914930462092,3.0,2.0,32.29643999999996
5469061,1524151200,1524151217,17,83,9.455596686283593,5.0,1.0,53.90181704593787
5469062,1524151216,1524151229,13,186,6.885041042009458,3.0,2.0,39.35311970588228
5469063,1524151229,1524151235,6,180,12.025816178170862,4.0,2.0,55.0
5469064,1524151234,1524151257,23,197,9.887421984549073,3.001,2.0,50.007653030767656
5469065,1524151255,1524151258,3,56,14.57486226671215,5.0,2.0,55.0
5469066,1524151260,1524151278,18,256,2.224201706046652,2.0,2.0,2.0
5469067,1524151278,1524151303,25,210,9.438474857912098,4.0,2.0,50.0
5469068,1524151303,1524151315,12,145,18.17213931630057,7.036137696347328,4.0,55.0
5469069,1524151313,1524151320,7,52,18.457212356484717,6.243493544847024,4.0,50.0
5469070,1524151320,1524151344,24,188,3.289475167762127,2.0,2.0,5.671053260869557
5469071,1524151343,1524151368,25,213,15.252910781038873,5.0,3.001,55.0
5469072,1524151369,1524151384,15,128,10.16614007831817,4.000000000018244,2.0,41.0
5469073,1524151384,1524151391,7,193,14.902195317626719,5.0,2.0,51.538783625730936
5469074,1524151389,1524151397,8,125,4.810837840793175,2.0,2.0,17.452132422957554
5469075,1524151397,1524151419,22,219,3.9804610723133136,2.0,1.0,9.282248726355778
5469076,1524151421,1524151437,16,158,9.809247944841754,4.000000000041025,2.0,50.0
5469077,1524151435,1524151442,7,187,7.1708066032923155,2.0,2.0,39.111974999999845
5469078,1524151442,1524151450,8,66,19.322847596812217,6.736150218581883,4.0,62.615667002424395
5469079,1524151445,1524151462,17,105,8.505136368980128,4.0,2.0,50.0
5469080,1524151462,1524151473,11,228,9.968739943875452,2.7261967116564416,1.0,56.15848620325534
5469081,1524151472,1524151492,20,163,3.257114877038613,2.0,1.8,5.0
5469082,1524151492,1524151499,7,202,14.18911061209643,5.0,3.0002908013052494,55.0
5469083,1524151497,1524151511,14,184,5.650664775360389,2.0,2.0,15.86511351705337
5469084,1524151510,1524151550,40,91,9.038993382321134,4.0,2.0,37.00247495752664
5469085,1524151550,1524151556,6,159,14.972926080620397,5.924800454837553,4.0,48.05487085577991
5469086,1524151556,1524151564,8,163,6.712197675700938,3.0,2.0,30.018509035204673
5469087,1524151566,1524151578,12,122,9.590963381982027,3.001,2.0,46.394342434606415
5469088,1524151578,1524151600,22,79,8.715218920705098,2.9987234754098364,2.00000003309702,51.50589527858323
5469089,1524151599,1524151608,9,219,12.920323585129154,2.0,2.0,69.16578975038377
5469090,1524151607,1524151624,17,54,22.465103717484446,5.0,4.0,100.0
5469091,1524151625,1524151628,3,135,7.505144228083677,4.9380852118808045,2.0,20.0
5469092,1524151627,1524151651,24,193,4.64543113422846,2.0,2.0,10.763599999999956
5469093,1524151650,1524151686,36,158,8.422458818954285,2.0,2.0,41.0
5469094,1524151686,1524151710,24,220,16.53742572145062,5.0,2.0,90.0
5469095,1524151708,1524151724,16,175,14.992344535374418,5.0,2.0,74.78855160750616
5469096,1524151723,1524151731,8,140,20.759084064474177,8.73409781892872,1.0,91.0
5469097,1524151729,1524151735,6,179,6.497723807830084,2.0,2.0,47.27974106680463
5469098,1524151733,1524151747,14,182,4.478278153475524,2.0,1.78125,23.777017872340423
5469099,1524151747,1524151793,46,36,42.28116864085406,50.0,0.0,91.0
5469100,1524151794,1524151801,7,201,15.789609646751503,5.0,1.0,50.48737668144026
5469101,1524151800,1524151809,9,88,7.012549013366734,3.001,2.157287294990471,23.000182753174602
5469102,1524151809,1524151815,6,158,16.123181423306285,7.0,5.0,55.0
5469103,1524151815,1524151822,7,260,3.0559350820914077,2.0,1.0,5.0
5469104,1524151820,1524151830,10,209,6.25236489154299,4.0,2.0,21.0
5469105,1524151829,1524151845,16,237,6.877370588940447,5.0,3.001,29.389266400228557
5469106,1524151843,1524151883,40,214,8.482659717433231,5.0,2.0,35.536135135135126
5469107,1524151883,1524151898,15,187,16.281373147978027,11.505631848013335,4.0,46.7877574370384
5469108,1524151896,1524151913,17,146,7.8701179175813145,5.0,1.0,18.94957732945335
5469109,1524151912,1524151916,4,42,40.54612617912018,45.67241901469004,20.695678816199376,55.0
5469110,1524151914,1524151930,16,9,52.054054054054056,55.0,24.35625,55.0
5469111,1524151931,1524151960,29,193,16.585310630094437,6.848185973741768,4.0,50.0
5469112,1524151959,1524151967,8,203,11.462700703189588,5.0,1.0,50.346610152297984
5469113,1524151965,1524151979,14,193,6.716720589852148,4.0,3.0,21.456447841258672
5469114,1524151978,1524151988,10,169,5.602961689435238,3.0,2.0,20.38868881578946
5469115,1524151986,1524151999,13,187,9.623747597241127,4.0,1.0,50.0
5469116,1524151998,1524152032,34,165,8.54709923414861,4.0,2.0,45.59101525889574
5469117,1524152030,1524152050,20,133,11.298073201844213,4.000000001,3.001,50.0
5469118,1524152045,1524152055,10,167,13.215526099559552,5.0,3.0,50.97258295184361
5469119,1524152055,1524152072,17,93,5.483360614431476,2.0,2.0,14.0
5469120,1524152070,1524152075,5,129,6.527876453644975,3.1023896194690246,2.0,30.0
5469121,1524152072,1524152117,45,119,2.93227827694229,2.0,1.502638159,7.280603279140981
5469122,1524152117,1524152136,19,173,34.67149482886301,30.0,5.0,74.49451279479472
5469123,1524152134,1524152144,10,174,8.335274187506725,4.008312389833363,2.0,50.0
5469124,1524152143,1524152185,42,115,6.251071942728793,2.0,1.7000001,19.229556563319676
5469125,1524152185,1524152196,11,252,21.477418806606988,11.640162930521504,1.0,50.0
5469126,1524152193,1524152214,21,173,7.3302510681939115,4.000000000462605,2.0,17.10269724010822
5469127,1524152213,1524152220,7,167,14.156720384443876,6.047567133258679,2.0,49.879275433881965
5469128,1524152219,1524152238,19,165,13.50390524794914,5.0,3.001,55.0
5469129,1524152237,1524152260,23,140,7.932449850870625,3.0,1.8274442528857051,42.014849967452705
5469130,1524152259,1524152279,20,161,23.03848992582975,5.0,3.001,55.0
5469131,1524152279,1524152287,8,163,6.527680640598019,3.0,2.0,30.0
5469132,1524152288,1524152292,4,29,39.461753120750764,33.71575342465754,17.0,91.23905298117359
5469133,1524152291,1524152321,30,168,5.1855165993605254,5.0,3.0,6.0
5469134,1524152321,1524152330,9,127,14.809333185680263,4.9802654941824445,3.0,54.17635328805936
5469135,1524152330,1524152336,6,180,7.653693037614682,2.0,1.0,46.973589655172354
5469136,1524152334,1524152358,24,105,5.218098763741756,2.0,1.5,37.108480882352914
5469137,1524152357,1524152365,8,215,11.116836663374055,3.830484927998752,1.5,52.302260813988234
5469138,1524152363,1524152369,6,30,54.4232267220187,50.0,50.0,96.22752823745729
5469139,1524152369,1524152381,12,89,7.346967712998534,5.0,3.001,27.17958164799986
5469140,1524152382,1524152390,8,151,6.015848711629383,2.0,1.5,35.53561841204637
5469141,1524152389,1524152412,23,123,12.760920639164624,3.358547221052632,3.0,55.0
5469142,1524152412,1524152430,18,182,10.342217301387377,4.0,1.5,50.0
5469143,1524152423,1524152453,30,150,4.461174811417153,2.0,1.6911941917384754,14.360265882352932
5469144,1524152453,1524152461,8,179,13.978796902976617,5.0,1.0,50.8583308787834
5469145,1524152460,1524152478,18,206,7.630778864713909,2.0,1.456301476098816,50.0
5469146,1524152477,1524152483,6,115,13.328558932581917,6.958978440837344,4.0,49.19203815042866
5469147,1524152483,1524152498,15,42,20.99157565221431,5.0,3.0,50.0
5469148,1524152497,1524152513,16,167,6.391911608801178,2.0,1.5,40.02929003690036
5469149,1524152511,1524152525,14,172,4.5100404377509875,2.0,1.5,20.0
5469150,1524152525,1524152547,22,183,5.738307651757515,2.0,1.5,27.351190778069824
5469151,1524152546,1524152563,17,147,23.427503466426458,5.0,4.0,91.0
5469152,1524152562,1524152574,12,163,11.66630791898111,3.001,2.0,50.0
5469153,1524152575,1524152607,32,227,5.777246335917666,2.0,1.5,41.0
5469154,1524152607,1524152618,11,261,14.884767242534002,3.001,1.5,50.0
5469155,1524152619,1524152632,13,128,23.38906929482272,7.891549328461539,4.0,54.879695593272025
5469156,1524152632,1524152636,4,48,27.637461123687906,8.730479338842974,4.0,110.14635296437743
5469157,1524152635,1524152654,19,137,5.591364398326784,2.182439977653615,1.5,43.24553681006685
5469158,1524152653,1524152709,56,205,20.587154721272768,5.226280991735536,2.1,55.0
5469159,1524152709,1524152715,6,69,30.356621028993583,40.0,6.000079464212883,53.95655150466108
5469160,1524152715,1524152735,20,120,10.02909394727307,7.640441085466618,4.0,23.001
5469161,1524152733,1524152757,24,151,36.26466584154195,54.001,5.0,55.0
5469162,1524152756,1524152762,6,150,18.06592544825809,5.0,4.0,51.94649994175174
5469163,1524152759,1524152765,6,133,3.7553546924418635,3.001,2.0,5.0
5469164,1524152763,1524152779,16,146,4.211834404105766,2.0,1.5,8.157241818181781
5469165,1524152777,1524152817,40,131,11.01206133457858,5.0,0.8812798947368421,52.047207113402045
5469166,1524152818,1524152830,12,260,12.170447315609087,5.0,1.0,50.35061180320871
5469167,1524152833,1524152844,11,190,5.540370703990047,4.0,1.646553893722586,20.01470315
5469168,1524152844,1524152879,35,245,5.771023308377185,1.5,1.5,40.77448082220807
5469169,1524152878,1524152900,22,118,11.226644787734514,5.137073670021206,2.6466008389261746,50.14905041423902
5469170,1524152899,1524152911,12,160,13.137884352527504,5.0,3.2,53.357679964433885
5469171,1524152908,1524152915,7,149,7.737971188355978,3.1288489432242024,1.194552143426816,46.47914665384832
5469172,1524152914,1524152932,18,183,3.6797030252615466,2.0,1.5,12.800940433014546
5469173,1524152930,1524152967,37,66,13.030798831558712,8.358343890775632,5.0,50.56931695
5469174,1524152967,1524152991,24,64,48.45175381359613,50.0,20.0,99.03451433524091
5469175,1524152990,1524152997,7,56,30.38774222193068,20.0,17.0,51.90001090135896
5469176,1524152996,1524153019,23,220,4.943571674295622,5.0,1.0,11.53545231934584
5469177,1524153016,1524153035,19,189,9.715534555456633,4.0,2.0,50.0
5469178,1524153034,1524153042,8,166,13.462744808139009,4.000000000039756,2.0,53.47807789538412
5469179,1524153041,1524153058,17,64,50.536430949072106,50.0,40.047903173391575,55.0
5469180,1524153059,1524153086,27,96,6.627577555947118,2.862702082514735,2.0,28.83282316241212
5469181,1524153086,1524153097,11,210,11.88652557785276,5.0,1.0,41.0
5469182,1524153096,1524153102,6,133,8.558050514587974,5.0,3.0,50.0
5469183,1524153102,1524153107,5,36,5.461162778735652,4.047878537677195,1.0,11.20616034131483
5469184,1524153107,1524153127,20,110,5.414052615091093,2.0,2.0,22.55157494588739
5469185,1524153126,1524153132,6,121,9.857379694447799,5.0,2.0,44.170203486560915
5469186,1524153131,1524153149,18,8,9.90746759617647,0.02174177149047619,0.0,81.44108597285063
5469187,1524153149,1524153156,7,190,15.051953591941066,3.48316,1.5,62.479702505768664
5469188,1524153154,1524153166,12,185,5.046846030253818,1.5,1.5,36.71450450450444
5469189,1524153167,1524153180,13,122,4.6897557251938995,2.1,1.0,16.025272352941155
5469190,1524153179,1524153201,22,132,10.549560778259863,1.5,1.0,50.0
5469191,1524153201,1524153239,38,186,16.919394816151094,5.0,1.0,55.143504636276184
5469192,1524153236,1524153249,13,186,27.819710531875515,17.0,5.0,91.0
5469193,1524153248,1524153260,12,122,8.400828664592176,5.0,2.1,25.667310868259094
5469194,1524153260,1524153272,12,163,4.401985264433484,2.3691907887139614,2.0,8.858535074776963
5469195,1524153272,1524153304,32,102,11.613246404116174,5.0,5.0,51.64107357112662
5469196,1524153301,1524153308,7,145,10.840839144584047,5.0,2.0,55.0
5469197,1524153306,1524153315,9,102,6.011929442196782,2.0,1.1203057704689052,21.29338551635828
5469198,1524153315,1524153337,22,112,3.097320959395137,2.0,1.11,5.533698912117643
5469199,1524153335,1524153347,12,168,7.253142429553564,3.78097407241063,1.21,40.67486029727201
5469200,1524153344,1524153358,14,100,9.620559927601079,5.0,2.1085872895779905,50.0
5469201,1524153357,1524153402,45,180,4.510413421604071,2.0,1.0,10.425103585809826
5469202,1524153401,1524153424,23,196,15.103691600660706,5.0,3.0,54.694129589073256
5469203,1524153422,1524153449,27,119,8.596099284014674,5.0,1.5,41.0
5469204,1524153447,1524153456,9,166,22.544574722226574,7.249244523624178,5.0,55.0
5469205,1524153455,1524153466,11,199,4.445222863102121,4.0,1.0,5.560203428571429
5469206,1524153465,1524153473,8,82,10.566669667636459,5.0,4.0,50.0
5469207,1524153472,1524153496,24,138,2.5138365633229456,2.0,1.5,3.48316
5469208,1524153497,1524153509,12,110,10.871247397833015,5.0,5.0,50.0
5469209,1524153508,1524153515,7,174,6.124017693455856,4.0,1.0,21.466846229187066
5469210,1524153514,1524153546,32,90,6.568568371809717,3.6,2.0,31.589436545543414
5469211,1524153545,1524153556,11,139,13.609899163563794,5.0,5.0,54.29
5469212,1524153556,1524153566,10,165,8.012709752106288,5.0,2.0,35.495651295213904
5469213,1524153567,1524153585,18,135,11.529210648523375,5.0,2.0,55.0
5469214,1524153584,1524153608,24,145,14.7192886144602,5.0,2.0,54.50598853725969
5469215,1524153608,1524153624,16,85,46.474337748172104,50.0,20.863464600613163,54.955223808
5469216,1524153630,1524153641,11,251,6.946574463743231,2.0,1.0,42.795024214426505
5469217,1524153641,1524153646,5,227,24.482867946660555,14.152254857142857,5.0,91.0
5469218,1524153644,1524153666,22,220,6.923823285769225,5.0,5.0,20.0
5469219,1524153666,1524153683,17,153,10.414963551252654,5.0,4.0,50.0
5469220,1524153683,1524153705,22,161,8.739361581789588,5.0,2.0,50.0
5469221,1524153706,1524153716,10,208,13.135375031288763,4.787865454545469,2.0,50.0
5469222,1524153713,1524153745,32,105,6.768025881670271,2.0,1.7000000663504926,48.835968911917
5469223,1524153743,1524153752,9,205,17.25556349694105,5.0,2.0,50.0
5469224,1524153749,1524153760,11,125,2.903470832081814,1.2,1.1,5.0
5469225,1524153760,1524153769,9,249,15.694021231455691,5.0,1.0,53.81696206882538
5469226,1524153766,1524153780,14,150,3.779738013500231,2.0,1.5,5.0
5469227,1524153780,1524153792,12,100,5.094112114633474,2.5,1.1,21.235478004535132
5469228,1524153791,1524153800,9,35,42.85382347188819,41.0,20.0,51.821471544320666
5469229,1524153798,1524153814,16,26,31.83476489565443,19.568533864337198,12.640715615500538,61.8528057065217
5469230,1524153813,1524153825,12,166,7.017769535936063,5.0,3.0,18.340202485882124
5469231,1524153824,1524153850,26,132,10.622934474058026,5.0,4.0,50.0
5469232,1524153848,1524153870,22,177,17.676252342885793,5.606975471457696,3.2,50.0
5469233,1524153870,1524153876,6,217,11.770104773220067,4.599840160848662,2.0,50.0
5469234,1524153876,1524153894,18,63,2.9583349434975372,2.0,1.1,5.0
5469235,1524153895,1524153919,24,125,9.393831522410887,4.0,1.1,50.0
5469236,1524153918,1524153924,6,158,17.664452384061303,5.0,5.0,55.0
5469237,1524153922,1524153936,14,173,2.8468403351048854,2.0,1.2573313151998105,5.0
5469238,1524153936,1524153962,26,109,7.42723615044748,2.0,1.0,50.0
5469239,1524153962,1524153978,16,193,8.890099729563062,4.0,1.1,50.0
5469240,1524153977,1524153980,3,148,27.9905716796772,10.606553551024815,5.0,55.60600963870704
5469241,1524153979,1524154030,51,101,2.204133115555346,2.0,1.1,4.0
5469242,1524154029,1524154035,6,211,15.950455046091232,5.0,4.0,50.0
5469243,1524154034,1524154059,25,101,18.000408602346372,5.0,3.0,55.0
5469244,1524154060,1524154066,6,228,12.886943396506654,5.0,1.0,50.0
5469245,1524154065,1524154081,16,55,13.207674280281413,5.0,4.0,50.0
5469246,1524154081,1524154085,4,103,13.042195039733453,5.0,2.0,50.0
5469247,1524154084,1524154103,19,126,3.2823755649126793,2.0,1.1,5.0
5469248,1524154102,1524154142,40,27,41.94252384544827,50.0,20.0,54.74438148148147
5469249,1524154142,1524154162,20,123,12.195404104775443,5.0,1.1,50.146111926605506
5469250,1524154161,1524154171,10,185,12.892237627906239,5.0,3.0,46.64257704662509
5469251,1524154170,1524154178,8,166,7.083958346275566,2.5110482608695652,2.0,50.0
5469252,1524154179,1524154183,4,120,11.559412684531969,5.0,1.1,50.0
5469253,1524154183,1524154189,6,136,15.275797083347987,5.0,1.1498597622108357,91.0
5469254,1524154189,1524154197,8,179,2.003053321270061,1.0,1.0,5.0
5469255,1524154197,1524154202,5,130,9.138904257132046,5.0,3.0,36.89133873387121
5469256,1524154202,1524154215,13,224,3.803883432349548,2.0,1.0,5.945949086419752
5469257,1524154217,1524154225,8,21,56.24998095315717,55.0,22.0,91.0
5469258,1524154225,1524154237,12,109,9.483185921897075,5.0,2.667290666666668,55.0
5469259,1524154237,1524154242,5,98,5.835432444198856,2.0,1.0000000004246041,41.0
5469260,1524154242,1524154262,20,76,2.2358007137918747,1.5,1.0,5.0
5469261,1524154261,1524154284,23,95,10.618247691426108,5.0,3.0,50.0
5469262,1524154285,1524154370,85,219,13.351649921680792,4.0,1.0,50.0
5469263,1524154369,1524154376,7,181,31.41576267263043,23.522073019801976,5.0,50.0
5469264,1524154375,1524154381,6,146,11.359746472697864,5.0,3.0,20.0
5469265,1524154379,1524154388,9,137,5.1756593067936905,2.0,1.2619990945571722,20.135840362811788
5469266,1524154384,1524154400,16,151,6.440449813205716,1.0,1.0,22.0
5469267,1524154400,1524154406,6,127,8.930881711126277,3.4215788261421127,1.0,50.0
5469268,1524154406,1524154417,11,148,21.11760981192123,5.0,5.0,55.0
5469269,1524154416,1524154439,23,177,6.891661128141009,2.0,1.0,50.0
5469270,1524154439,1524154444,5,175,10.887260756991434,4.0,1.0,50.0
5469271,1524154444,1524154455,11,205,15.99473550363288,5.0,1.0,55.0
5469272,1524154453,1524154475,22,76,9.680208723014218,5.0,1.7106591549295795,50.0
5469273,1524154475,1524154490,15,137,7.714012852179955,5.0,2.0,25.00152058823529
5469274,1524154489,1524154538,49,174,8.821418305445418,3.0,1.6,50.0
5469275,1524154530,1524154541,11,167,11.374605445668251,4.0,1.4133297419342135,50.0
5469276,1524154541,1524154545,4,127,11.770007668743373,5.0,1.0,50.0
5469277,1524154544,1524154571,27,120,13.144637502086756,5.0,3.0,50.0
5469278,1524154571,1524154577,6,203,18.140041212083695,5.0,1.0,55.0
5469279,1524154576,1524154599,23,28,7.7491054786314555,4.0,2.453246285714286,20.48546802721088
5469280,1524154598,1524154604,6,148,13.542337271790732,5.0,3.0,51.55367361192747
5469281,1524154603,1524154609,6,60,3.0572732296878136,2.0,1.1,4.95164404814604
5469282,1524154609,1524154633,24,46,8.261746891845865,5.0,1.0957413012666315,23.50232055244444
5469283,1524154633,1524154645,12,151,12.26604039548763,5.0,4.0,50.0
5469284,1524154646,1524154658,12,129,5.120037208280023,2.039233960844263,1.0,20.0
5469285,1524154657,1524154682,25,191,8.768262406845903,2.0,1.0,55.0
5469286,1524154681,1524154700,19,204,11.755122849270641,4.000000000059713,1.0,50.0
5469287,1524154701,1524154710,9,126,7.534022603390971,4.0,1.0,22.0
5469288,1524154710,1524154733,23,197,7.234206244487184,1.2441003389830505,1.0,50.0
5469289,1524154732,1524154753,21,162,11.188791701833786,5.0,1.0,47.99989515472756
5469290,1524154753,1524154769,16,190,8.426294468326507,4.0,1.0,50.0
5469291,1524154767,1524154779,12,104,7.706983155464925,5.0,1.000000002475909,30.0
5469292,1524154778,1524154815,37,188,5.101470071610975,1.0,0.9840525775585865,20.838427368696106
5469293,1524154815,1524154826,11,136,43.88560013132479,50.0,20.0,55.0
5469294,1524154825,1524154856,31,194,9.861365715068944,5.168363745267077,1.0,39.04530441281667
5469295,1524154855,1524154860,5,187,11.435175579553848,5.0,2.0,31.954796888888872
5469296,1524154861,1524154878,17,220,6.45522718776336,4.0,1.0,42.605004076311516
5469297,1524154877,1524154888,11,105,6.302247323622769,4.0,1.8984347522493619,22.0
5469298,1524154888,1524154892,4,116,7.883368638555698,4.0,2.0,44.48827777777774
5469299,1524154892,1524154957,65,13,23.222634171796283,25.25493732156639,0.0,55.0
5469300,1524154956,1524154984,28,197,20.13678471058338,11.032400000000008,5.0,55.0
5469301,1524154982,1524154990,8,188,14.456589643145698,5.0,4.0,60.0
5469302,1524154988,1524155025,37,121,5.100843192422891,3.0,2.0,20.202910940076936
5469303,1524155026,1524155036,10,191,12.185577777419924,5.0,1.78125,48.118419199999956
5469304,1524155036,1524155050,14,132,7.617487139233747,2.0,1.0,50.0
5469305,1524155048,1524155082,34,163,5.221914926897324,2.0,1.6,23.462419047618983
5469306,1524155081,1524155115,34,162,20.38701652864746,5.0,5.0,54.61568674844401
5469307,1524155114,1524155124,10,197,8.517709646160036,4.00145189602884,4.0,40.0
5469308,1524155122,1524155128,6,108,3.7128427743945442,2.0,1.0853412640625002,6.05078764705881
5469309,1524155127,1524155136,9,128,2.5292188183204694,2.0,1.0,5.057489240506326
5469310,1524155134,1524155138,4,141,7.321935237495826,5.0,4.0,30.0
5469311,1524155139,1524155158,19,114,2.5777651865772504,1.0000010226814717,1.0,10.915442589017282
5469312,1524155156,1524155183,27,94,20.884593203568965,11.310000001,4.0,50.159441891097785
5469313,1524155183,1524155192,9,267,15.396852415155966,5.0,1.0,50.0
5469314,1524155191,1524155202,11,207,13.596920779404233,4.0,1.0,55.0
5469315,1524155200,1524155214,14,138,3.268915213441776,2.0,1.0,5.0
5469316,1524155214,1524155251,37,107,10.252338150241059,3.968909714393088,1.0000000105642004,48.395152783531856
5469317,1524155251,1524155270,19,151,17.79038950781264,5.0,5.0,50.0
5469318,1524155269,1524155296,27,145,7.853027500348637,4.0,2.5,41.0
5469319,1524155296,1524155301,5,144,17.16759761909087,5.0,5.0,55.0
5469320,1524155311,1524155321,10,30,49.77124339545956,55.0,17.0,102.82481589403973
5469321,1524155321,1524155344,23,153,9.686697302527552,4.722477499999999,3.18106,52.19389380971081
5469322,1524155343,1524155361,18,137,6.653387816383338,3.0459745000000003,2.0,22.0
5469323,1524155358,1524155369,11,140,7.1345269290486515,4.0,1.0,30.620162857142784
5469324,1524155368,1524155378,10,149,21.068783380836635,5.0,3.286,96.0610902672166
5469325,1524155377,1524155390,13,76,3.3439426314965908,2.0,1.0000321877166667,8.809066399999958
5469326,1524155390,1524155411,21,148,12.90870621646821,5.0,1.0,35.49565529788652
5469327,1524155412,1524155428,16,149,8.545510448125652,4.0,1.0225619437175657,50.0
5469328,1524155427,1524155449,22,198,14.8338429451528,5.0,3.869340930589187,59.14283996082271
5469329,1524155447,1524155459,12,255,9.553946256976507,5.0,3.0,34.119952777777755
5469330,1524155458,1524155472,14,178,9.698015834314452,5.0,1.0,50.0
5469331,1524155469,1524155526,57,170,6.9313533700505054,4.0,1.0,33.734959411764684
5469332,1524155527,1524155532,5,239,17.86280476322797,6.145891011749652,1.0,50.0
5469333,1524155530,1524155537,7,166,8.542688623975675,4.0,2.0,40.22664989304335
5469334,1524155536,1524155569,33,154,4.289231577361337,2.0,1.0,12.216215172413687
5469335,1524155568,1524155582,14,160,56.19792008154288,50.0,44.92763828952299,100.0
5469336,1524155581,1524155592,11,181,9.099784103498333,5.0,2.0,34.83946257980555
5469337,1524155590,1524155596,6,135,4.605399441760011,2.0,1.0,18.738104705882336
5469338,1524155596,1524155608,12,157,7.159617860266174,2.0,1.0,32.18873425356771
5469339,1524155605,1524155616,11,183,4.3500414691369915,1.0,1.0,12.983193357933573
5469340,1524155615,1524155626,11,151,9.372682236960049,5.0,4.0,55.0
5469341,1524155625,1524155636,11,136,10.023056971565683,5.0,2.0,40.74656756756744
5469342,1524155634,1524155637,3,35,38.96008979484831,39.04529794604981,22.0,55.0
5469343,1524155636,1524155642,6,77,6.313140341930908,5.0,4.0,11.757949554377175
5469344,1524155641,1524155649,8,131,2.9717714996869447,2.0,1.0,10.099982090639237
5469345,1524155650,1524155668,18,21,33.326490626053314,34.27582421376048,0.0,92.34862087421945
5469346,1524155667,1524155677,10,152,11.563180959213629,5.0,3.0,55.0
5469347,1524155674,1524155679,5,68,9.769527853539474,5.0,4.0,52.21773998652365
5469348,1524155677,1524155686,9,133,3.6481548319763157,2.0,1.0,16.007512816619634
5469349,1524155687,1524155692,5,65,6.590354106741901,5.0,4.0,11.02492129142739
5469350,1524155690,1524155698,8,72,3.2107646653287727,2.0,2.0,5.0
5469351,1524155695,1524155705,10,50,4.250743011915723,5.0,2.0,5.0
5469352,1524155702,1524155716,14,92,8.715450360052843,5.0,3.0,31.036319878756053
5469353,1524155715,1524155735,20,122,6.136664757795022,4.0,1.0,24.984422500984422
5469354,1524155734,1524155752,18,58,42.577198777755896,50.0,20.0,55.0
5469355,1524155753,1524155771,18,126,6.652310613948018,5.0,1.0,23.0914252252252
5469356,1524155771,1524155788,17,168,8.698835204835031,4.0,2.0,40.0
5469357,1524155790,1524155807,17,180,10.107146573426569,2.786118322419499,1.0,50.0
5469358,1524155806,1524155833,27,140,6.906923421871643,4.0,1.0,40.833171586715864
5469359,1524155837,1524155849,12,149,16.9675150364742,5.0,5.0,55.0
5469360,1524155849,1524155858,9,143,8.59429872894325,4.0,2.0,41.0
5469361,1524155857,1524155876,19,143,2.650997135208361,1.6,1.0,7.233614933160823
5469362,1524155877,1524155884,7,187,15.843035230702814,5.0,1.0,54.70698530884807
5469363,1524155884,1524155892,8,277,5.383245913020267,1.0,1.0,20.0
5469364,1524155890,1524155898,8,202,7.397827510465334,2.0,1.0,20.0
5469365,1524155897,1524155923,26,124,12.242494643605077,5.0,2.0,50.0
5469366,1524155922,1524155929,7,40,39.39375193351486,24.0,20.0,104.8682588235294
5469367,1524155927,1524155940,13,167,3.1140495988057877,2.0,1.0,6.0
5469368,1524155939,1524155963,24,136,11.329034739421886,5.0,1.0,50.0
5469369,1524155963,1524155979,16,172,12.781227215260838,5.0,1.0,56.0098949360112
5469370,1524155978,1524155990,12,86,9.362059277942476,5.0,2.0,47.455134177215136
5469371,1524155988,1524155999,11,193,8.19340505756487,1.1386324888747166,1.0,20.817835030099292
5469372,1524155999,1524156026,27,153,10.012736036038516,4.588479640449439,1.0,41.57737048296334
5469373,1524156025,1524156044,19,148,22.438267382185913,14.210783741150166,5.0,55.0
5469374,1524156043,1524156064,21,156,6.246305025952854,4.0,1.1025353646153848,25.692861999999995
5469375,1524156064,1524156069,5,176,5.37317985543523,4.0,1.0,20.0
5469376,1524156069,1524156082,13,136,7.3928396665861245,5.0,1.0,21.374950174489587
5469377,1524156084,1524156102,18,48,30.73345080077888,20.594690444444446,20.0,55.0
5469378,1524156103,1524156124,21,99,7.970035293198127,5.0,4.6110943137254905,24.0
5469379,1524156123,1524156135,12,170,10.096199329116796,4.000000000882331,2.0,50.0
5469380,1524156135,1524156175,40,115,14.027417063525174,5.0,5.0,50.0
5469381,1524156175,1524156196,21,234,64.98057303568329,5.0,1.0,60.29448991304347
5469382,1524156192,1524156200,8,170,11.820245905687079,5.0,1.0,30.0
5469383,1524156199,1524156220,21,173,2.783485961309825,2.0,1.0,5.0
5469384,1524156221,1524156229,8,163,6.548297184023493,4.0,1.0,43.31251581511883
5469385,1524156228,1524156238,10,100,8.842436584549542,5.0,2.0,21.60571840546697
5469386,1524156238,1524156248,10,75,9.61723967595796,5.0,1.0,48.42943157894728
5469387,1524156248,1524156258,10,192,3.985705944038437,1.1,1.0,10.0
5469388,1524156255,1524156272,17,183,4.8892542793002685,1.0,1.0,30.0
5469389,1524156268,1524156282,14,201,7.671907094063154,2.0,1.0,41.0
5469390,1524156279,1524156285,6,217,11.277499268519737,5.0,1.0,38.45465129902458
5469391,1524156283,1524156296,13,205,5.093985310548137,1.0,1.0,34.54672475247515
5469392,1524156300,1524156335,35,125,10.58403455442024,5.0,4.0,55.0
5469393,1524156338,1524156347,9,228,10.76074987721486,1.1006568153846155,1.0,48.57703870629048
5469394,1524156347,1524156356,9,166,8.317089175622371,5.0,1.0,21.42026291571754
5469395,1524156357,1524156374,17,205,66.73610847019232,2.0,1.0,48.94916622983158
5469396,1524156372,1524156385,13,171,22.612882854309618,5.006460509090909,4.0,50.0
5469397,1524156383,1524156388,5,136,5.3579082312700015,2.0,1.0,36.05772416963765
5469398,1524156387,1524156395,8,97,13.26484381472488,5.0,1.0,53.303878849851934
5469400,1524156398,1524156401,3,151,2.9687711385020497,2.0,1.0,6.582181416984457
5469401,1524156402,1524156413,11,50,13.279009743894894,5.0,4.493764545454546,38.13478872233333
5469402,1524156411,1524156442,31,38,5.546605950799139,3.2045026091102025,2.5625,16.487081391276195
5469403,1524156448,1524156491,43,198,15.141942428068207,5.3146978732638885,3.2365961985930745,51.96926885582039
5469404,1524156491,1524156516,25,48,29.544326730801036,23.60378571428571,0.0,66.98220070422526
5469405,1524156516,1524156550,34,169,13.934914314347832,5.0,4.0,50.0
5469406,1524156549,1524156599,50,183,10.244917921889407,5.0,2.0,49.40492038504937
5469407,1524156597,1524156602,5,174,20.654181464052897,6.0,4.0,56.41561998041134
5469408,1524156601,1524156619,18,121,4.7020185064869535,2.0,1.0,24.22131984621499
5469409,1524156618,1524156632,14,195,9.39528126825828,5.0,1.0,47.922306863584375
5469410,1524156631,1524156650,19,118,9.118445677466267,4.575173327228038,1.0,39.83604791813223
5469411,1524156652,1524156663,11,170,10.625771893014136,4.9,1.0,50.97362890133059
5469412,1524156664,1524156679,15,22,24.479571825383342,20.375271877031533,20.0,46.724410204081614
5469413,1524156677,1524156690,13,190,40.67089078731493,50.0,5.0,55.0
5469414,1524156689,1524156740,51,167,7.38371734300075,4.034745313152547,4.0,35.68786867896285
5469415,1524156737,1524156744,7,186,15.7456252086721,5.0,2.0,73.30250866879607
5469416,1524156744,1524156758,14,146,8.845886547895946,4.0,1.0000001,40.665514406824414
5469417,1524156758,1524156767,9,152,1.8189510600904812,1.0,1.0,5.137505691699604
5469418,1524156768,1524156776,8,266,9.050277105631636,1.9968174120761555,1.0,50.0
5469419,1524156774,1524156806,32,206,8.130487694314782,2.0,1.0,41.0
5469420,1524156806,1524156863,57,143,9.995539703694067,5.0,2.0,41.0
5469421,1524156863,1524156868,5,183,29.567584926119366,11.92658728582068,4.0,55.0
5469422,1524156866,1524156878,12,107,4.527601303375215,2.0,1.0000000946261218,17.416723417918053
5469423,1524156877,1524156882,5,163,19.171468338549197,10.0,1.0,55.0
5469424,1524156885,1524156894,9,122,22.97023377470928,10.0,10.0,55.0
5469425,1524156894,1524156917,23,6,8.313138836112,0.012951865238095241,0.0,51.9
5469426,1524156919,1524156936,17,180,12.830308907402928,5.0,1.0,55.96901188927722
5469427,1524156936,1524156966,30,152,10.572383833844071,4.0,1.0,56.15155291428405
5469428,1524156965,1524156974,9,206,17.60085202132991,8.0,1.0,55.0
5469429,1524156972,1524156980,8,179,4.611055710716372,2.0,1.0,20.497803666666666
5469430,1524156979,1524156985,6,134,23.225713095623934,1.0,1.0,50.328628975853455
5469431,1524156982,1524157002,20,71,49.58991490739196,50.0,40.0,55.0
5469432,1524157002,1524157029,27,228,5.079137652260751,2.0,1.0,20.0
5469433,1524157029,1524157036,7,208,14.593145167695123,5.450638253393782,1.0,50.0
5469434,1524157035,1524157051,16,127,11.38852561151373,10.0,2.0000000647235003,50.0
5469435,1524157048,1524157055,7,130,10.494919857531453,10.0,1.0,48.99061882263831
5469436,1524157056,1524157083,27,180,6.89334926457345,2.0,1.0,30.28232581004983
5469437,1524157082,1524157091,9,229,8.851506459669345,4.0,1.0,46.26957907079143
5469438,1524157090,1524157110,20,153,5.997992676194039,1.0000131357402122,1.0,34.852073074303824
5469439,1524157109,1524157116,7,212,11.283761295899017,4.0,1.0,58.675903036238964
5469440,1524157114,1524157118,4,125,4.328447670191963,2.0,1.0,14.34332492029748
5469441,1524157117,1524157121,4,187,6.714788908654775,1.0,1.0,50.0
5469442,1524157120,1524157134,14,169,3.3525818808777075,1.0,1.0,16.47359311181639
5469443,1524157133,1524157178,45,204,4.84941147322144,1.0,1.0,20.0
5469444,1524157177,1524157183,6,71,47.99441827670436,40.0,20.0,97.25928799999997
5469445,1524157183,1524157190,7,105,8.440929237725344,10.0,5.0,10.0
5469446,1524157188,1524157221,33,150,11.977105311232899,5.0,1.0,31.645146948286467
5469447,1524157221,1524157231,10,221,22.580319809209815,15.0,5.0,50.0
5469448,1524157230,1524157235,5,255,5.855498703041549,5.0,2.0,13.176254674751155
5469449,1524157234,1524157239,5,150,16.381992014275298,11.380346523120272,1.0,42.58627075584868
5469450,1524157238,1524157255,17,251,3.555164904806392,2.0,1.0,10.301688127328452
5469451,1524157253,1524157265,12,143,14.188050478879532,10.0,5.0,40.0
5469452,1524157263,1524157297,34,167,8.067817368134564,5.0,1.0,20.0
5469453,1524157295,1524157318,23,223,20.642678263240665,19.242785430495083,1.0,55.0
5469454,1524157317,1524157331,14,152,15.195328025166583,10.0,4.0,50.0
5469455,1524157330,1524157349,19,91,13.900440592888364,4.18843184296671,1.9272594598653239,50.0
5469456,1524157348,1524157371,23,108,13.825050167022123,5.0,2.0,94.07529926716845
5469457,1524157369,1524157384,15,141,14.598108537426253,5.0,2.436344582667243,50.0
5469458,1524157384,1524157389,5,99,7.427009738849407,3.0,1.1,50.0
5469459,1524157389,1524157395,6,92,4.743400992442478,2.0,1.0,20.050007207207152
5469460,1524157394,1524157403,9,143,5.658234475172029,2.0,1.0,15.152768599999959
5469461,1524157401,1524157405,4,12,2.484728897060989,2.0,1.214643302011658,4.669516990920879
5469462,1524157405,1524157408,3,104,2.3361384327323975,1.403785868852459,1.0,5.0
5469463,1524157408,1524157418,10,13,3.1082263852601844,2.0,1.0427845156624937,11.768140909090897
5469464,1524157418,1524157422,4,168,3.7542735446564617,1.045771333836717,1.0,20.0
5469465,1524157423,1524157434,11,10,6.488270477114647,0.024541427914228562,0.0,24.465030855127793
5469466,1524157433,1524157442,9,179,18.500947968648916,5.0,2.0,60.1687419505552
5469467,1524157440,1524157446,6,156,9.889875600050056,7.3565258064516135,2.0,31.251726538095003
5469468,1524157445,1524157488,43,255,6.739787716301634,2.065058888888889,2.0,20.672673975422548
5469469,1524157486,1524157499,13,162,54.37971503968466,5.0,4.0,52.04719950040863
5469470,1524157499,1524157543,44,139,15.823639448004904,10.0,2.2310139951493335,55.0
5469471,1524157541,1524157557,16,169,12.750293315471385,4.137355833351517,2.0,45.819433023366
5469472,1524157557,1524157571,14,268,6.428030163417693,4.0,1.0,40.0
5469473,1524157571,1524157586,15,135,5.8243195039953335,4.0,2.0,23.298658749999966
5469474,1524157583,1524157597,14,65,11.752239045565187,5.0,2.5461641099114134,50.0
5469475,1524157600,1524157618,18,136,7.229618494837638,5.0,1.0212047873762409,21.592296825396794
5469476,1524157618,1524157661,43,174,12.146598576676672,2.0,1.0,88.11016212765955
5469477,1524157660,1524157717,57,197,12.190373821456825,5.0,1.0,50.0
5469478,1524157716,1524157722,6,188,16.421372322084082,9.640221542553192,1.0,51.631469199999984
5469479,1524157720,1524157726,6,198,8.510984478591904,4.0,2.0,55.0
5469480,1524157726,1524157764,38,133,2.9628537074452312,1.0,1.0,12.816368553459098
5469481,1524157763,1524157771,8,182,10.293227899959305,4.8344559167685075,2.0,50.0
5469482,1524157770,1524157778,8,118,16.50457259640072,10.0,2.0,55.0
5469483,1524157775,1524157782,7,173,1.8278767880137146,1.0,1.0,5.0
5469484,1524157780,1524157807,27,136,16.108644148639872,5.303786687972135,2.0,55.0
5469485,1524157808,1524157850,42,183,13.424206482224353,4.0,1.0,50.0
5469486,1524157849,1524157889,40,191,10.204440221963822,4.0,1.0,50.0
5469487,1524157888,1524157927,39,182,32.59613070098256,10.0,1.0,61.660940888888874
5469488,1524157929,1524157944,15,154,27.782566644789394,20.0,6.0,55.0
5469489,1524157944,1524157949,5,178,11.549268750555953,5.0,1.0,50.0
5469490,1524157949,1524157955,6,20,21.529713445284955,7.48819463838048,0.0,73.87276158940395
5469491,1524157955,1524157969,14,197,4.793022668836119,4.0,2.0,12.0
5469492,1524157967,1524157988,21,163,4.800888845577652,3.0347811406470613,1.0,11.967238484848485
5469493,1524157987,1524157999,12,168,8.754891118537596,2.0,1.0,48.79255691256577
5469494,1524157997,1524158008,11,97,13.802811629578942,10.0,2.0,55.0
5469495,1524158006,1524158012,6,180,5.304660980419771,2.0,1.0,26.96495351351348
5469496,1524158014,1524158019,5,170,8.92495598385689,1.0,1.0,50.0
5469497,1524158021,1524158030,9,249,1.933081566924695,1.0,1.0,2.6091765820475556
5469498,1524158031,1524158040,9,136,9.030970202409991,5.089347504761905,1.0,38.90635830297718
5469499,1524158038,1524158046,8,113,11.21908446325213,5.271015678950697,2.0,50.0
5469500,1524158046,1524158058,12,138,6.343785658676028,1.912921129493464,1.0,43.393857060185084
5469501,1524158058,1524158072,14,231,9.427240652670442,4.000000000149042,1.0,42.651370267939804
5469502,1524158072,1524158088,16,184,12.927088284637207,4.0,1.0,51.96928581072535
5469503,1524158088,1524158096,8,216,6.407925407789059,1.0,1.0,42.89337468099744
5469504,1524158094,1524158104,10,144,5.355899791635122,1.0,1.0,29.451996615998688
5469505,1524158103,1524158113,10,217,4.300440813406921,1.0,1.0,14.035771245847176
5469506,1524158111,1524158128,17,179,7.148905545768042,2.0,1.0,41.0
5469507,1524158129,1524158144,15,182,9.315204090060039,4.000000000034988,1.0,41.0
5469508,1524158140,1524158146,6,166,4.019631056680191,1.0,1.0,24.0
5469509,1524158144,1524158182,38,203,4.793739537965308,2.0,1.0,21.550790069733
5469510,1524158181,1524158207,26,88,32.028626520993235,20.0,1.9033863503916968,81.33080502401792
5469511,1524158207,1524158221,14,167,7.236498086206608,5.0,2.033410423538035,22.27889639639638
5469512,1524158220,1524158241,21,152,8.076818098994954,2.0,1.0,51.44692234716015
5469513,1524158239,1524158244,5,209,7.514746380792921,2.0,1.0,41.61313304828891
5469514,1524158243,1524158259,16,186,2.5233202489954234,1.0,1.0,5.609560625591769
5469515,1524158260,1524158280,20,206,8.147482149234248,2.0,1.0,50.0
5469516,1524158279,1524158290,11,163,6.6160293671901895,3.780789802289282,2.0,30.0
5469517,1524158289,1524158309,20,118,11.60818779663673,2.0,1.0,50.0
5469518,1524158309,1524158330,21,157,12.948140528953612,5.0,2.0,50.044342648533906
5469519,1524158331,1524158345,14,191,7.1627653043594055,2.2320784212488904,1.0,34.78495042965647
5469520,1524158343,1524158349,6,218,7.65396213345226,2.0,1.0,50.56469755434781
5469521,1524158348,1524158360,12,238,5.442445455812606,1.8846497591550044,1.0,38.03145161290322
5469522,1524158358,1524158366,8,241,4.527268142902961,2.0,1.0,20.0
5469523,1524158366,1524158386,20,170,34.24065258078875,50.0,10.0,55.0
5469524,1524158385,1524158401,16,194,7.621788473239896,4.0,1.0,45.29561362413869
5469525,1524158401,1524158436,35,190,11.47059729917579,4.0,2.0,50.0
5469526,1524158435,1524158469,34,162,24.336943271899298,10.316814698193914,2.0,50.0
5469527,1524158468,1524158482,14,176,7.029563888893982,2.0,1.0,41.0
5469528,1524158480,1524158491,11,163,15.524667278141747,2.5776439999999994,1.0,50.0
5469529,1524158491,1524158507,16,161,12.023617549561157,4.000000000923432,1.0,50.3518679399041
5469530,1524158506,1524158518,12,201,30.704487428268564,35.0,4.729227510340074,55.0
5469531,1524158517,1524158536,19,207,9.935819551861632,2.0,1.0,50.0
5469532,1524158534,1524158541,7,168,9.29867765422315,2.0,1.0,50.0
5469533,1524158540,1524158544,4,171,5.032297068134668,2.0,1.0,21.819366071428572
5469534,1524158542,1524158549,7,12,49.514091361870825,50.0,24.056034343434348,53.1
5469535,1524158548,1524158562,14,154,5.4963712803769225,2.0,1.0,20.0
5469536,1524158562,1524158580,18,223,7.334505982737436,1.0,1.0,50.0
5469537,1524158581,1524158594,13,157,13.001173356006028,8.5898752,2.0,50.0
5469538,1524158583,1524158624,41,213,1.2866082658745843,1.0,1.0,2.0
5469539,1524158623,1524158640,17,150,15.941817521889693,5.0,2.0,55.0
5469540,1524158640,1524158665,25,81,19.852415202235903,20.0,2.0,50.0
5469541,1524158663,1524158668,5,173,14.787794757302729,5.216801234567902,2.0,50.0
5469542,1524158668,1524158683,15,5,0.0085109624,0.0,0.0,0.021277406
5469543,1524158683,1524158702,19,144,16.697401214337603,5.0,2.0,50.87607917617631
5469544,1524158701,1524158707,6,217,10.49511339194442,2.0,1.0,50.0
5469545,1524158707,1524158713,6,325,5.278085366223521,1.0,1.0,49.36344343262848
5469546,1524158713,1524158720,7,203,6.546289072534018,2.0,1.0,48.25442221535161
5469547,1524158720,1524158728,8,95,9.626994522106749,1.2708679999999994,1.0,50.0
5469548,1524158727,1524158741,14,164,10.58586021027256,4.000000000045733,2.0,50.0
5469549,1524158741,1524158760,19,141,8.716582568789349,1.1500234074074074,1.0,46.52368571428563
5469550,1524158759,1524158761,2,197,12.932594239066844,3.0,1.6,50.0
5469551,1524158760,1524158767,7,99,12.013815941033133,10.0,4.0,45.83537199999999
5469552,1524158765,1524158777,12,148,2.917040450062506,1.0,1.0,21.44530619188309
5469553,1524158775,1524158783,8,19,45.0238041508033,50.0,21.035848620964696,55.0
5469554,1524158782,1524158802,20,18,36.74393003838497,44.33405194805195,20.0,55.0
5469555,1524158800,1524158826,26,150,13.78994128352581,5.0,2.0,51.961584586329
5469556,1524158824,1524158829,5,95,15.551963936973898,11.104760416666673,2.0,50.0
5469557,1524158828,1524158838,10,65,7.434379615454608,3.0,2.0,34.84069780093567
5469558,1524158837,1524158846,9,124,9.449225794999945,4.387536243396753,1.0,29.521152527825542
5469559,1524158845,1524158849,4,55,19.692669081206255,5.565038208168644,2.0,51.30911008241123
5469560,1524158848,1524158875,27,201,9.390670025630982,1.0,1.0,28.690848159570827
5469561,1524158874,1524158885,11,244,10.118020716295748,1.0,1.0,50.0
5469562,1524158884,1524158889,5,124,8.360382794092542,5.0,1.1,50.0
5469563,1524158888,1524158921,33,58,13.071064596093128,5.0,0.23539363944107922,50.0
5469564,1524158921,1524158940,19,64,45.06693165223139,41.0,0.0,55.0
5469565,1524158938,1524158968,30,135,12.59664370572676,5.049236721311475,2.0,47.397802031086535
5469566,1524158968,1524158987,19,149,38.501828917218646,15.000000000497849,2.0,106.41183704683407
5469567,1524158986,1524159024,38,129,14.424062986096331,4.0,1.1,50.0
5469568,1524159023,1524159089,66,213,22.77673508977483,10.0,5.0,53.0
5469569,1524159088,1524159105,17,271,16.4025734034622,5.0,5.0,50.0
5469570,1524159105,1524159136,31,245,20.678747758240103,5.0,1.0,51.969192792043664
5469571,1524159135,1524159145,10,265,17.526659678206894,12.797476014760148,1.0,50.0
5469572,1524159144,1524159151,7,172,30.12568821417128,45.0,5.0,55.0
5469573,1524159150,1524159154,4,89,5.827916442811118,4.0,1.0,29.215664999999976
5469574,1524159154,1524159168,14,183,8.81414901989724,3.0,2.0,29.335254592452234
5469575,1524159168,1524159192,24,112,8.370334142406913,2.0,2.0,55.38537545454543
5469576,1524159192,1524159202,10,146,16.921723855396017,5.0,2.0,50.0
5469577,1524159201,1524159219,18,80,6.473390986872074,2.0,1.096073541,22.645672747771158
5469578,1524159217,1524159242,25,105,11.8418070204326,5.0,2.0,50.0
5469579,1524159241,1524159250,9,105,9.924909136694962,5.0,2.0,50.0
5469580,1524159249,1524159256,7,111,6.754858290248665,2.0,1.0,30.0
5469581,1524159255,1524159263,8,156,21.402883940421194,20.0,2.0,50.0
5469582,1524159261,1524159309,48,108,4.345451818145725,1.1,1.0,27.073326126125906
5469583,1524159310,1524159329,19,173,19.965112423488723,8.0,1.0,50.03533586818758
5469584,1524159327,1524159352,25,145,10.229613957632901,6.24822520803909,1.1,22.0
5469585,1524159351,1524159358,7,142,10.89632241278839,5.0,2.0,50.487739228571414
5469586,1524159357,1524159362,5,173,8.005772636858758,1.5,1.0,41.96495260115601
5469587,1524159360,1524159366,6,219,4.1183106527326485,1.0,1.0,11.006118909346581
5469588,1524159367,1524159381,14,204,3.8573992262723036,1.0,1.0,18.213769999999993
5469589,1524159379,1524159389,10,178,8.089038063132698,2.0,1.0,38.83145418545816
5469590,1524159387,1524159397,10,78,32.779959210974845,38.68130316742079,3.024304,55.0
5469591,1524159394,1524159400,6,191,3.0941416479797383,2.0,1.0,14.113619793083597
5469592,1524159399,1524159418,19,69,13.981192645184363,20.0,2.0,29.335236298218945
5469593,1524159418,1524159432,14,94,19.111722360026395,11.310000001,2.0,55.26634743665622
5469594,1524159432,1524159461,29,127,9.733095605227088,4.0,2.0,49.88809620142338
5469595,1524159461,1524159495,34,136,21.292022157602037,5.0,1.7233679259918515,54.37307056797283
5469596,1524159495,1524159499,4,151,22.340272873378304,15.734726651480639,2.5052727700450896,55.0
5469597,1524159498,1524159509,11,170,1.691914711555156,1.0000450776021068,1.0,5.0
5469598,1524159506,1524159548,42,181,2.965757882118391,1.0,1.0,5.642264249999997
5469599,1524159546,1524159555,9,272,8.494506708908649,2.0,1.0,50.0
5469600,1524159552,1524159567,15,194,6.638595764551733,2.0,1.0,50.0
5469601,1524159566,1524159588,22,135,9.90963650537489,5.0,1.0,22.0
5469602,1524159588,1524159612,24,138,9.556743025198246,4.0,2.0,50.0
5469603,1524159608,1524159614,6,167,20.91904409556242,8.017618776255551,2.0,56.438327314193586
5469604,1524159612,1524159632,20,206,2.5434710070162376,1.0,1.0,6.754572581707812
5469605,1524159632,1524159640,8,147,21.870367211638722,5.0,2.0,50.4236059201674
5469606,1524159638,1524159647,9,26,9.938583401863658,9.149657114240014,0.3,20.0
5469607,1524159646,1524159664,18,224,10.696267547455015,2.0,2.0,50.0
5469608,1524159664,1524159670,6,115,9.940244785994643,2.0,1.0,40.4074239202883
5469609,1524159669,1524159676,7,93,4.0355523639896,2.0,1.0,20.0
5469610,1524159674,1524159682,8,109,15.768608861628994,5.0,1.0,50.0
5469611,1524159682,1524159731,49,80,16.439294226632796,5.0,2.0,50.0
5469612,1524159729,1524159744,15,70,45.24492292428559,24.642656826568263,20.0,100.0
5469613,1524159744,1524159756,12,41,30.676106441139467,30.833781225641943,12.0,50.0
5469614,1524159756,1524159761,5,155,11.433744218809675,5.0,1.0,29.46723619909495
5469615,1524159759,1524159774,15,157,3.438363583914078,2.0,2.0,5.0
5469616,1524159772,1524159793,21,204,6.159307897391924,1.8858046806469297,1.0,35.49571060308934
5469617,1524159792,1524159820,28,179,9.322052918599526,4.0,1.0,41.0
5469618,1524159818,1524159825,7,209,6.561216247903352,3.0,1.6,30.0
5469619,1524159822,1524159836,14,208,2.211960191088252,1.0,1.0,4.355104874999998
5469620,1524159833,1524159840,7,142,2.8611962278171275,1.0,1.0,10.22557014496857
5469621,1524159839,1524159857,18,215,13.19807755028135,5.442851488919485,1.0,50.234627600650406
5469622,1524159855,1524159864,9,65,16.747110904415802,10.0,1.099234233020867,50.201578594708955
5469623,1524159863,1524159878,15,138,8.028230845099195,5.0,2.0,26.668391791018408
5469624,1524159878,1524159886,8,279,4.847093780339861,1.045517265538456,1.0,23.902889999999925
5469625,1524159886,1524159891,5,128,17.89532118334156,10.0,2.0,50.0
5469626,1524159888,1524159892,4,77,8.992367963834397,2.672896791842825,1.0,21.805604113273215
5469627,1524159891,1524159899,8,176,6.537465299811986,5.0,1.0,16.18249924224045
5469628,1524159896,1524159925,29,208,5.1204668999953,2.0,1.0,19.348534339688598
5469629,1524159923,1524159929,6,27,50.6545520604948,51.96915602325556,41.212319139220405,55.0
5469630,1524159929,1524159939,10,175,9.08340703579428,5.769793476968581,1.0,20.0
5469631,1524159938,1524159953,15,51,13.92720323971017,10.0,4.0,50.908461376022665
5469632,1524159952,1524159963,11,175,6.045844140694396,2.0,2.0,30.0
5469633,1524159963,1524159993,30,137,6.428981808076897,1.160085861181334,1.0,30.19516533014579
5469634,1524159992,1524159996,4,45,48.72419191068525,49.40326102185322,22.0,54.952112549226506
5469635,1524159994,1524160013,19,123,6.158899560440974,5.0,2.0,12.027316169605088
5469636,1524160012,1524160018,6,12,15.238134862850679,0.018064671,0.0,63.0
5469637,1524160017,1524160023,6,110,14.21124266256443,5.0,2.0,50.0
5469638,1524160022,1524160035,13,184,2.2627225532567885,1.147725096153846,1.0,5.0
5469639,1524160035,1524160042,7,66,10.65429464897842,5.0,2.7402346478873243,50.0
5469640,1524160038,1524160075,37,129,2.52997555380865,1.0,1.0,5.0
5469641,1524160074,1524160081,7,139,14.893213236960769,10.0,2.0,55.0
5469642,1524160078,1524160082,4,18,12.808497709417432,17.653682327247775,2.0,27.880676369327073
5469643,1524160081,1524160085,4,9,2.756799095980651,2.1407660579751524,2.0,5.229841250452681
5469644,1524160084,1524160106,22,151,3.4771874856565175,2.0,1.0,13.731394028233977
5469645,1524160105,1524160109,4,190,9.9501556981014,2.0,1.0,50.435035518129496
5469646,1524160107,1524160121,14,20,8.623191215433636,10.0,4.0,13.192722114244576
5469647,1524160113,1524160132,19,163,2.930031421448853,2.0,1.0,4.6278045999999975
5469648,1524160130,1524160138,8,165,6.343685617236377,2.0,1.0,27.66393272312392
5469649,1524160137,1524160145,8,212,2.762444180882471,1.0,1.0,11.992546747117894
5469650,1524160144,1524160160,16,234,4.2058858524215,1.0,1.0,15.067411224644317
5469651,1524160159,1524160174,15,177,8.731270742131459,2.0,1.0,22.0
5469652,1524160173,1524160181,8,199,13.099415939001663,4.923370790739627,2.0,53.40567692450525
5469653,1524160182,1524160190,8,110,28.142199961551423,14.916393675882482,5.0,55.0
5469654,1524160185,1524160212,27,173,7.690661416227664,2.0,2.0,20.0
5469655,1524160211,1524160222,11,131,13.97208751829206,5.0,2.141457904314376,55.0
5469656,1524160219,1524160239,20,96,12.687806012788174,5.0,2.0,39.045245286758096
5469657,1524160238,1524160247,9,187,10.638440012010458,4.0,2.0,41.0
5469658,1524160247,1524160274,27,119,12.56544684414074,5.0,2.0,41.07325703282079
5469659,1524160274,1524160293,19,251,9.254108665297364,3.0,1.0,50.0
5469660,1524160293,1524160297,4,157,8.760731912965701,4.0,1.0,50.0
5469661,1524160297,1524160325,28,194,1.7943530129426866,1.0,1.0,2.0
5469662,1524160323,1524160345,22,192,13.58031518960376,2.0,1.8308556584928777,55.0
5469663,1524160344,1524160355,11,160,10.71007553497796,2.0,1.0,55.91781096963761
5469664,1524160353,1524160377,24,175,13.581665043606009,4.0,1.6,50.0
5469665,1524160376,1524160387,11,170,15.281703160683017,2.293196862745098,0.3,55.0
5469666,1524160385,1524160402,17,14,32.30801212060112,32.90437836624352,20.0,46.63618694817658
5469667,1524160401,1524160416,15,97,10.62859668702862,4.0,2.0,48.0368348222079
5469668,1524160415,1524160420,5,150,7.7356487735752415,2.0,1.0,22.16740638297871
5469669,1524160418,1524160426,8,157,24.531342275101984,1.0100009997363406,1.0,100.0
5469670,1524160424,1524160446,22,35,27.11748231269712,31.800010959342398,2.805426604054377,49.847743310386235
5469671,1524160446,1524160454,8,144,26.187325876966252,3.013638015681102,1.0,100.0
5469672,1524160453,1524160469,16,192,3.177244246948548,1.0,1.0,9.089019999999985
5469673,1524160468,1524160497,29,105,15.856724028634476,5.0,2.0,50.57979471859725
5469674,1524160496,1524160503,7,84,16.737932597511442,9.67872839747615,2.0,52.07079067094985
5469675,1524160502,1524160534,32,166,6.856529173372601,2.0,1.0,24.9305758713801
5469676,1524160531,1524160548,17,179,10.827530614389033,3.951451239669429,1.0,46.96293022869809
5469677,1524160547,1524160553,6,168,10.40437171747493,2.0,1.0,41.0
5469678,1524160551,1524160560,9,148,2.8501707466445585,1.0,1.0,5.014886373635163
5469679,1524160558,1524160563,5,208,3.8502568578588496,2.0,2.0,5.278980219757828
5469680,1524160560,1524160565,5,12,39.45711981785409,20.0,20.0,106.82723966942149
5469681,1524160563,1524160582,19,72,6.11478507808509,4.0,2.0,19.2694093446958
5469682,1524160577,1524160585,8,189,7.912859621257656,2.0,1.0,40.46617650133457
5469683,1524160580,1524160608,28,164,4.202224325025265,1.0419635371219673,1.0,13.871828136555772
5469684,1524160607,1524160626,19,268,13.312522213188782,2.209165058936284,1.0,50.01160464618967
5469685,1524160623,1524160635,12,215,9.883473663359084,2.0,2.0,50.0
5469686,1524160635,1524160644,9,147,4.994112602118117,1.322392856884438,1.0,22.935263592678908
5469687,1524160640,1524160656,16,185,3.728773645318938,1.13374475,1.0,20.03639975664344
5469688,1524160656,1524160665,9,17,40.59584744914631,37.66309380642491,20.0,90.11268798841967
5469689,1524160664,1524160683,19,188,5.892777747974405,3.0,2.0,20.0
5469690,1524160682,1524160688,6,146,4.479246194580061,2.0,1.1,13.975392456917836
5469691,1524160688,1524160730,42,239,5.231743009896384,1.177119692307692,1.0,23.961607941774382
5469692,1524160728,1524160736,8,158,15.152384654138796,6.0,2.0,51.96915954199914
5469693,1524160736,1524160748,12,170,17.941793731349886,4.0,2.0,50.0
5469694,1524160746,1524160774,28,154,2.735187550932516,1.0,1.0,3.7269931512500967
5469695,1524160772,1524160779,7,117,21.376057829482658,5.441754491590214,5.0,53.02572360992001
5469696,1524160776,1524160793,17,137,9.563778820887658,4.0,2.0,20.858893703527922
5469697,1524160792,1524160798,6,182,4.9348127072985015,2.0,1.0,22.660300369003668
5469698,1524160797,1524160835,38,172,4.383055937697838,1.0,1.0,24.24400111375823
5469699,1524160831,1524160866,35,263,14.346535506815396,12.0,5.0,47.78972537382577
5469700,1524160865,1524160891,26,241,14.668812031834424,5.0,3.0604610978957,50.0
5469701,1524160891,1524160918,27,183,18.177271465580244,10.0,2.1001603205030963,55.0
5469702,1524160919,1524160936,17,278,6.810708913557476,2.0,1.0,41.0
5469703,1524160933,1524160947,14,160,4.3905396694923455,2.0,1.5,20.618383876691347
5469704,1524160946,1524160958,12,21,15.902220622235292,12.427865659833634,0.0,51.27110921212121
5469705,1524160958,1524160963,5,160,7.727417888097546,2.0,1.0,33.0
5469706,1524160961,1524160969,8,246,6.812697399461774,2.01,2.0,50.0
5469707,1524160964,1524160976,12,57,8.854937440307543,2.0,1.0,29.334107460035508
5469708,1524160977,1524161006,29,57,27.27150161914385,20.0,0.015337036,55.0
5469709,1524161005,1524161020,15,117,9.478122265874912,3.0,3.0,51.9
5469710,1524161019,1524161033,14,152,8.101172092370051,2.0,2.0,41.0
5469711,1524161032,1524161040,8,177,2.9665797870720363,1.1416478622376531,1.0,5.76942670588235
5469712,1524161040,1524161052,12,169,4.338007344576701,1.0000477454451917,1.0,20.0
5469713,1524161051,1524161074,23,224,8.262935829788185,1.8429969135802498,1.0,42.941286508866824
5469714,1524161073,1524161116,43,148,7.760890020285095,2.034777252991056,1.0,20.897093572393374
5469715,1524161115,1524161132,17,102,18.277332578053553,21.0,2.0,51.35299868571427
5469716,1524161131,1524161135,4,15,50.288941723287984,42.94971939292349,40.0,99.0
5469717,1524161134,1524161193,59,94,14.042978417457729,10.0,5.0,50.0
5469718,1524161193,1524161226,33,225,14.232042173311426,5.0,1.0,50.29225898526913
5469719,1524161224,1524161231,7,147,15.327730614875305,5.680175510204082,2.0,51.965682135392576
5469720,1524161229,1524161246,17,24,31.158576336806448,50.0,0.0,55.0
5469721,1524161246,1524161250,4,99,15.628202106417834,10.0,10.0,50.0
5469722,1524161247,1524161254,7,127,8.9497883779449,2.0,2.0,42.471712853086686
5469723,1524161251,1524161261,10,132,5.479163536588997,2.0,1.1,19.518408140216753
5469724,1524161259,1524161265,6,113,8.227447822327314,10.0,2.0,18.212060399999924
5469725,1524161262,1524161283,21,156,2.6561898365662158,1.3394664049079754,1.0,9.659499345088149
5469726,1524161269,1524161298,29,147,6.967845153383849,10.0,1.0,10.0
5469727,1524161297,1524161305,8,202,9.157443361567987,2.0,2.0,50.0
5469728,1524161305,1524161320,15,150,2.10879519925777,1.0,1.0,5.0
5469729,1524161317,1524161328,11,191,13.906326189851153,2.2040157480314964,2.0,50.95743274853795
5469730,1524161327,1524161336,9,159,5.506150588900747,1.1,1.0,34.28995331166747
5469731,1524161335,1524161342,7,208,3.8906768870907027,2.0,2.0,5.75963688217768
5469732,1524161339,1524161356,17,72,6.348933475975428,4.767230583090998,2.0,11.310020879672917
5469733,1524161356,1524161363,7,177,5.9794222478908825,1.8319559158180807,1.0,30.0
5469734,1524161362,1524161373,11,93,8.421715449113593,1.1603431687184824,1.0,48.86705427804968
5469735,1524161373,1524161377,4,180,4.843316316962324,1.165263611485612,1.0,20.295998051948047
5469736,1524161377,1524161384,7,118,7.503978804978437,2.0,2.0,49.873619801609834
5469737,1524161380,1524161390,10,52,2.4350097145542566,2.0,2.0,5.0
5469738,1524161389,1524161407,18,95,4.144706796346076,1.0,1.0,26.32148022297327
5469739,1524161408,1524161424,16,161,4.620370238325148,2.0,1.0,13.994025841354127
5469741,1524161429,1524161439,10,175,6.296185183259962,2.0,1.0,35.0
5469742,1524161436,1524161447,11,214,4.219772381847594,2.0,1.0,9.18762999999999
5469743,1524161440,1524161450,10,137,3.5561231811539775,2.0,2.0,5.0
5469744,1524161446,1524161458,12,199,3.5800464634603495,1.0,1.0,21.560820664206396
5469745,1524161455,1524161465,10,211,1.9477224610979496,1.0,1.0,4.0
5469746,1524161464,1524161499,35,158,5.627334314540877,2.0,1.0,21.629877999999977
5469747,1524161497,1524161505,8,197,10.892151207735212,4.00000000014329,1.0,56.470241555183556
5469748,1524161503,1524161523,20,161,2.7596214580767886,2.0,1.0,5.826523333333326
5469749,1524161521,1524161529,8,190,4.096099667871768,2.0,1.0,20.0
5469750,1524161528,1524161543,15,196,8.916028955336696,2.0,2.0,28.31544997690531
5469751,1524161543,1524161557,14,142,5.107441987381475,1.1,1.0,20.878070270270243
5469752,1524161556,1524161568,12,163,6.274343673026174,2.0,1.0,41.0
5469753,1524161565,1524161577,12,174,10.81947978384916,2.0,2.0,55.0
5469754,1524161576,1524161582,6,145,10.703482385791084,4.061698069852941,1.0,38.01977261267716
5469755,1524161578,1524161589,11,149,1.7655476531726362,1.8095032739068797,1.0,2.0
5469756,1524161587,1524161602,15,225,6.1187209663180875,2.0,2.0,22.0
5469757,1524161601,1524161615,14,111,5.839433391886457,2.0,1.0,21.494281764706944
5469758,1524161612,1524161626,14,157,16.090201386318594,5.0,1.492511782870145,52.72148608909236
5469759,1524161625,1524161634,9,189,9.921216241218774,3.3854299999999995,2.0,50.0
5469760,1524161632,1524161645,13,91,9.003694015270575,4.0,4.0,50.0
5469761,1524161644,1524161670,26,180,6.869725355230726,2.2455315315315287,2.0,22.0
5469762,1524161661,1524161671,10,194,4.218141363036751,2.0,1.6,10.690483394833935
5469763,1524161666,1524161680,14,85,3.0510621311983748,1.0,1.0,8.816414315882772
5469764,1524161677,1524161691,14,197,6.881616621511542,4.0,2.0,50.0
5469765,1524161691,1524161697,6,249,3.1640515818140518,1.0,1.0,11.61152559999999
5469766,1524161696,1524161732,36,202,5.2283049968814,2.0,1.6,24.686170838803044
5469767,1524161730,1524161764,34,130,12.909927100342134,4.0,1.0,52.67834758210013
5469768,1524161755,1524161765,10,142,13.990715605228107,5.7925548553719,2.0,50.22486163117145
5469769,1524161759,1524161766,7,174,2.492429437786918,2.0,1.6,4.82538109090909
5469770,1524161764,1524161796,32,149,3.2183471011592952,1.3468381349693253,1.0,12.060039248605976
5469771,1524161795,1524161812,17,152,14.604772164797318,5.0,2.0,50.0
5469772,1524161810,1524161817,7,47,41.38133520624544,41.0,20.0,91.0
5469773,1524161813,1524161821,8,106,5.734376763226117,4.0,1.0,15.94613795929658
